YEAR,COUNTY,ST_TOTAL,ST_LE_TOTAL,ST_LE_SWORN,ST_LE_NONSWORN,ST_OTH_FUNDED_TOTAL,ST_OTH_FUNDED_SWORN,ST_OTH_FUNDED_NONSWORN,CNTY_TOTAL,CNTY_LE_TOTAL,CNTY_LE_SWORN,CNTY_LE_NONSWORN,CNTY_OTH_FUNDED_TOTAL,CNTY_OTH_FUNDED_SWORN,CNTY_OTH_FUNDED_NONSWORN,SO_FUNDED_TOTAL,SO_FUNDED_SWORN,SO_FUNDED_NONSWORN,PD_FUNDED_TOTAL,PD_FUNDED_SWORN,PD_FUNDED_NONSWORN,CHP_FUNDED_TOTAL,CHP_FUNDED_SWORN,CHP_FUNDED_NONSWORN,Prosecution,DA_Attorneys,DA_Investigators,DA_Clerical,DA_Other,PublicDefense,PD_Attorneys,PD_Investigators,PD_Clerical,PD_Other,ProbationDept,ProbationOfficers,PROB_Other
2003,Alameda County,6233,4737,3028,1709,251,140,111,6233,4737,3028,1709,251,140,111,1506,936,570,2980,1952,1028, , , ,373,165,93,115,0,193,116,22,48,7,930,270,660
2003,Alpine County,18,14,11,3, , , ,18,14,11,3, , , ,14,11,3, , , , , , ,2,1,0,1,0, , , , , ,2,1,1
2003,Amador County,160,116,70,46, , , ,160,116,70,46, , , ,90,48,42,26,22,4, , , ,28,8,10,7,3, , , , , ,16,11,5
2003,Butte County,717,508,267,241,17,11,6,717,508,267,241,17,11,6,256,106,150,235,150,85, , , ,107,27,40,32,8, , , , , ,102,58,44
2003,Calaveras County,138,104,63,41, , , ,138,104,63,41, , , ,95,55,40,9,8,1, , , ,16,7,2,5,2, , , , , ,18,12,6
2003,Colusa County,104,79,49,30, , , ,104,79,49,30, , , ,60,32,28,19,17,2, , , ,11,3,3,3,2, , , , , ,14,8,6
2003,Contra Costa County,3393,2628,1811,817,309,211,98,3114,2349,1619,730,30,19,11,1060,710,350,1259,890,369, , , ,198,96,31,54,17,136,93,9,21,13,431,198,233
2003,Del Norte County,112,70,42,28, , , ,112,70,42,28, , , ,56,29,27,14,13,1, , , ,11,4,4,3,0, , , , , ,31,9,22
2003,El Dorado County,623,478,233,245, , , ,623,478,233,245, , , ,384,170,214,94,63,31, , , ,52,17,9,17,9,17,11,1,5,0,76,42,34
2003,Fresno County,3542,2541,1452,1089,42,29,13,3542,2541,1452,1089,42,29,13,1076,467,609,1423,956,467, , , ,243,105,58,55,25,102,64,9,21,8,656,158,498
2003,Glenn County,134,91,50,41, , , ,134,91,50,41, , , ,66,29,37,25,21,4, , , ,7,3,1,3,0, , , , , ,36,11,25
2003,Humboldt County,606,412,304,108,20,12,8,606,412,304,108,20,12,8,236,189,47,156,103,53, , , ,64,16,12,20,16,17,10,2,5,0,113,80,33
2003,Imperial County,677,471,328,143, , , ,677,471,328,143, , , ,259,173,86,212,155,57, , , ,43,19,11,10,3,14,9,1,4,0,149,61,88
2003,Inyo County,143,93,72,21, , , ,143,93,72,21, , , ,73,58,15,20,14,6, , , ,14,4,3,5,2, , , , , ,36,12,24
2003,Kern County,2444,1704,935,769,14,10,4,2444,1704,935,769,14,10,4,1063,474,589,627,451,176, , , ,179,74,48,48,9,81,53,11,15,2,480,231,249
2003,Kings County,489,315,163,152, , , ,489,315,163,152, , , ,193,74,119,122,89,33, , , ,47,18,11,15,3, , , , , ,127,49,78
2003,Lake County,266,198,97,101, , , ,266,198,97,101, , , ,150,61,89,48,36,12, , , ,27,13,6,7,1, , , , , ,41,21,20
2003,Lassen County,162,118,93,25, , , ,162,118,93,25, , , ,96,74,22,22,19,3, , , ,8,4,1,2,1,5,3,0,2,0,31,11,20
2003,Los Angeles County,42661,34538,22900,11638,247,173,74,42661,34538,22900,11638,247,173,74,14461,8581,5880,19830,14146,5684, , , ,1979,957,238,520,264,1007,671,75,158,103,5137,2366,2771
2003,Madera County,353,203,145,58, , , ,353,203,145,58, , , ,110,78,32,93,67,26, , , ,33,12,11,8,2, , , , , ,117,50,67
2003,Marin County,915,671,483,188,8,5,3,915,671,483,188,8,5,3,306,207,99,357,271,86, , , ,95,40,11,29,15,45,26,4,11,4,104,58,46
2003,Mariposa County,78,59,49,10, , , ,78,59,49,10, , , ,59,49,10, , , , , , ,8,3,1,3,1, , , , , ,11,9,2
2003,Mendocino County,411,248,188,60, , , ,411,248,188,60, , , ,173,134,39,75,54,21, , , ,51,17,8,16,10,21,12,3,4,2,91,38,53
2003,Merced County,688,488,355,133, , , ,688,488,355,133, , , ,233,176,57,255,179,76, , , ,75,22,13,30,10,17,12,2,3,0,108,58,50
2003,Modoc County,48,37,31,6, , , ,48,37,31,6, , , ,27,22,5,10,9,1, , , ,5,1,1,3,0, , , , , ,6,4,2
2003,Mono County,79,66,44,22, , , ,79,66,44,22, , , ,43,26,17,23,18,5, , , ,7,3,1,2,1, , , , , ,6,5,1
2003,Monterey County,1373,953,722,231,21,19,2,1373,953,722,231,21,19,2,444,327,117,488,376,112, , , ,128,48,30,37,13,44,25,7,10,2,248,176,72
2003,Napa County,519,364,275,89,99,92,7,519,364,275,89,99,92,7,115,86,29,150,97,53, , , ,46,21,9,14,2,22,14,2,5,1,87,42,45
2003,Nevada County,368,267,125,142, , , ,368,267,125,142, , , ,197,71,126,70,54,16, , , ,26,11,2,13,0,12,8,0,4,0,63,22,41
2003,Orange County,10161,7718,4468,3250,62,45,17,10161,7718,4468,3250,62,45,17,3653,1793,1860,4003,2630,1373, , , ,642,228,120,188,106,361,191,74,61,35,1440,382,1058
2003,Placer County,903,679,406,273, , , ,903,679,406,273, , , ,396,219,177,283,187,96, , , ,93,35,10,44,4, , , , , ,131,98,33
2003,Plumas County,95,71,38,33, , , ,95,71,38,33, , , ,71,38,33, , , , , , ,10,3,2,2,3, , , , , ,14,10,4
2003,Riverside County,5844,4429,2519,1910,58,45,13,5844,4429,2519,1910,58,45,13,2944,1517,1427,1427,957,470, , , ,463,164,66,139,94,184,99,33,36,16,768,281,487
2003,Sacramento County,15979,14684,10365,4319,1055,861,194,4774,3479,2292,1187,52,37,15,2258,1507,751,1169,748,421,10202,7249,2953,443,165,52,107,119,149,96,26,22,5,703,557,146
2003,San Benito County,131,103,64,39, , , ,131,103,64,39, , , ,62,30,32,41,34,7, , , ,9,4,1,3,1, , , , , ,19,14,5
2003,San Bernardino County,6531,4744,2775,1969,132,62,70,6531,4744,2775,1969,132,62,70,2846,1534,1312,1766,1179,587, , , ,435,205,46,137,47,177,102,24,50,1,1175,390,785
2003,San Diego County,10528,7686,5234,2452,271,196,75,10528,7686,5234,2452,271,196,75,3166,1980,1186,4249,3058,1191, , , ,957,282,198,267,210,350,195,57,63,35,1535,1168,367
2003,San Francisco County,4176,3682,3103,579,103,67,36,4176,3682,3103,579,103,67,36,994,827,167,2585,2209,376, , , ,254,117,43,21,73,119,83,16,13,7,121,94,27
2003,San Joaquin County,2281,1668,927,741,21,15,6,2281,1668,927,741,21,15,6,718,298,420,929,614,315, , , ,202,82,51,41,28,87,52,15,18,2,324,128,196
2003,San Luis Obispo County,1091,847,511,336,179,145,34,1091,847,511,336,179,145,34,370,156,214,298,210,88, , , ,97,33,16,20,28, , , , , ,147,103,44
2003,San Mateo County,2286,1724,1254,470, , , ,2286,1724,1254,470, , , ,568,410,158,1156,844,312, , , ,123,54,11,37,21, , , , , ,439,328,111
2003,Santa Barbara County,1714,1118,783,335,58,33,25,1714,1118,783,335,58,33,25,623,447,176,437,303,134, , , ,142,50,24,42,26,71,34,12,20,5,383,256,127
2003,Santa Clara County,5404,3872,2880,992,111,59,52,5404,3872,2880,992,111,59,52,710,553,157,3051,2268,783, , , ,495,201,102,112,80,207,109,29,40,29,830,323,507
2003,Santa Cruz County,863,637,476,161,44,19,25,863,637,476,161,44,19,25,319,261,58,274,196,78, , , ,87,33,16,26,12, , , , , ,139,79,60
2003,Shasta County,635,433,260,173, , , ,635,433,260,173, , , ,249,135,114,184,125,59, , , ,76,23,18,20,15, , , , , ,126,51,75
2003,Sierra County,24,17,11,6, , , ,24,17,11,6, , , ,17,11,6, , , , , , ,2,1,0,1,0, , , , , ,5,3,2
2003,Siskiyou County,265,197,140,57, , , ,265,197,140,57, , , ,128,96,32,69,44,25, , , ,27,9,6,4,8,6,5,0,1,0,35,18,17
2003,Solano County,1595,1155,579,576,7,6,1,1595,1155,579,576,7,6,1,472,110,362,676,463,213, , , ,129,59,12,49,9,71,45,8,18,0,240,124,116
2003,Sonoma County,1708,1263,673,590,40,24,16,1708,1263,673,590,40,24,16,663,269,394,560,380,180, , , ,117,45,16,41,15,47,27,8,11,1,281,115,166
2003,Stanislaus County,1620,1247,654,593,22,11,11,1620,1247,654,593,22,11,11,628,226,402,597,417,180, , , ,128,45,19,49,15,43,25,4,9,5,202,153,49
2003,Sutter County,267,207,155,52, , , ,267,207,155,52, , , ,136,108,28,71,47,24, , , ,24,9,10,4,1, , , , , ,36,29,7
2003,Tehama County,259,174,127,47, , , ,259,174,127,47, , , ,114,87,27,60,40,20, , , ,24,8,5,8,3, , , , , ,61,29,32
2003,Trinity County,61,27,20,7, , , ,61,27,20,7, , , ,27,20,7, , , , , , ,12,4,3,3,2, , , , , ,22,9,13
2003,Tulare County,1569,1006,717,289,6,5,1,1569,1006,717,289,6,5,1,602,424,178,398,288,110, , , ,183,61,45,39,38,65,34,9,10,12,315,102,213
2003,Tuolumne County,217,156,84,72, , , ,217,156,84,72, , , ,139,71,68,17,13,4, , , ,23,7,2,7,7,7,4,1,2,0,31,17,14
2003,Ventura County,3071,2141,1332,809,16,12,4,3071,2141,1332,809,16,12,4,1343,798,545,782,522,260, , , ,282,96,69,64,53,80,51,11,12,6,568,445,123
2003,Yolo County,771,559,306,253,73,41,32,771,559,306,253,73,41,32,214,76,138,272,189,83, , , ,99,31,29,25,14,31,21,4,5,1,82,36,46
2003,Yuba County,287,130,90,40, , , ,287,130,90,40, , , ,91,61,30,39,29,10, , , ,19,12,3,3,1, , , , , ,138,38,100
2004,Alameda County,5560,4505,2898,1607,249,138,111,5560,4505,2898,1607,249,138,111,1456,922,534,2800,1838,962, , , ,349,161,72,116,0,188,114,22,45,7,518,251,267
2004,Alpine County,22,17,13,4, , , ,22,17,13,4, , , ,17,13,4, , , , , , ,2,1,0,1,0, , , , , ,3,2,1
2004,Amador County,164,109,66,43, , , ,164,109,66,43, , , ,83,44,39,26,22,4, , , ,34,8,14,6,6, , , , , ,21,14,7
2004,Butte County,740,503,265,238,22,14,8,740,503,265,238,22,14,8,252,102,150,229,149,80, , , ,95,26,30,31,8, , , , , ,142,57,85
2004,Calaveras County,140,105,64,41, , , ,140,105,64,41, , , ,96,56,40,9,8,1, , , ,16,7,2,5,2, , , , , ,19,13,6
2004,Colusa County,93,72,49,23, , , ,93,72,49,23, , , ,52,31,21,20,18,2, , , ,7,2,2,2,1, , , , , ,14,7,7
2004,Contra Costa County,3301,2556,1765,791,310,209,101,3022,2277,1576,701,31,20,11,1052,695,357,1194,861,333, , , ,192,97,24,54,17,133,86,9,20,18,420,192,228
2004,Del Norte County,114,70,43,27, , , ,114,70,43,27, , , ,56,30,26,14,13,1, , , ,10,3,3,4,0, , , , , ,34,9,25
2004,El Dorado County,611,472,230,242, , , ,611,472,230,242, , , ,376,168,208,96,62,34, , , ,50,17,9,15,9,17,11,1,5,0,72,40,32
2004,Fresno County,3604,2613,1518,1095,35,22,13,3604,2613,1518,1095,35,22,13,1080,474,606,1498,1022,476, , , ,246,106,57,58,25,99,60,9,22,8,646,151,495
2004,Glenn County,127,92,48,44, , , ,127,92,48,44, , , ,67,27,40,25,21,4, , , ,7,3,1,3,0, , , , , ,28,9,19
2004,Humboldt County,580,382,285,97,20,11,9,580,382,285,97,20,11,9,219,174,45,143,100,43, , , ,56,14,9,19,14,29,17,3,9,0,113,78,35
2004,Imperial County,653,447,312,135, , , ,653,447,312,135, , , ,238,160,78,209,152,57, , , ,45,18,10,14,3,14,9,1,4,0,147,60,87
2004,Inyo County,136,87,64,23, , , ,136,87,64,23, , , ,70,51,19,17,13,4, , , ,13,4,3,4,2, , , , , ,36,12,24
2004,Kern County,2472,1685,905,780,14,11,3,2472,1685,905,780,14,11,3,1047,461,586,624,433,191, , , ,169,70,44,43,12,81,53,11,15,2,537,225,312
2004,Kings County,491,318,168,150, , , ,491,318,168,150, , , ,199,80,119,119,88,31, , , ,47,18,10,15,4, , , , , ,126,46,80
2004,Lake County,265,199,100,99, , , ,265,199,100,99, , , ,149,62,87,50,38,12, , , ,25,12,6,7,0, , , , , ,41,21,20
2004,Lassen County,151,107,83,24, , , ,151,107,83,24, , , ,85,64,21,22,19,3, , , ,9,4,1,3,1,5,3,0,2,0,30,10,20
2004,Los Angeles County,41267,33419,22256,11163,267,180,87,41267,33419,22256,11163,267,180,87,13854,8215,5639,19298,13861,5437, , , ,1919,914,230,583,192,981,666,69,158,88,4948,2315,2633
2004,Madera County,322,189,136,53, , , ,322,189,136,53, , , ,102,71,31,87,65,22, , , ,29,12,7,8,2, , , , , ,104,43,61
2004,Marin County,897,656,472,184,9,7,2,897,656,472,184,9,7,2,315,211,104,332,254,78, , , ,89,34,11,29,15,44,26,4,10,4,108,58,50
2004,Mariposa County,81,62,51,11, , , ,81,62,51,11, , , ,62,51,11, , , , , , ,8,3,1,3,1, , , , , ,11,9,2
2004,Mendocino County,391,238,178,60, , , ,391,238,178,60, , , ,165,126,39,73,52,21, , , ,52,17,7,19,9,21,12,3,4,2,80,38,42
2004,Merced County,715,480,354,126, , , ,715,480,354,126, , , ,229,177,52,251,177,74, , , ,76,22,14,30,10,15,12,0,3,0,144,54,90
2004,Modoc County,46,36,31,5, , , ,46,36,31,5, , , ,26,22,4,10,9,1, , , ,5,1,1,2,1, , , , , ,5,3,2
2004,Mono County,80,67,45,22, , , ,80,67,45,22, , , ,43,26,17,24,19,5, , , ,7,3,1,2,1, , , , , ,6,5,1
2004,Monterey County,1332,927,707,220,7,6,1,1332,927,707,220,7,6,1,433,322,111,487,379,108, , , ,123,42,28,41,12,40,24,6,8,2,242,171,71
2004,Napa County,604,436,273,163,172,90,82,604,436,273,163,172,90,82,117,87,30,147,96,51, , , ,49,23,9,14,3,22,14,2,5,1,97,43,54
2004,Nevada County,353,253,128,125, , , ,353,253,128,125, , , ,176,67,109,77,61,16, , , ,25,11,2,12,0,12,8,0,4,0,63,22,41
2004,Orange County,9921,7504,4523,2981,64,43,21,9921,7504,4523,2981,64,43,21,3460,1872,1588,3980,2608,1372, , , ,641,245,174,143,79,373,197,72,63,41,1403,392,1011
2004,Placer County,940,717,417,300, , , ,940,717,417,300, , , ,409,215,194,308,202,106, , , ,92,34,11,44,3, , , , , ,131,98,33
2004,Plumas County,96,73,40,33, , , ,96,73,40,33, , , ,73,40,33, , , , , , ,9,3,2,1,3, , , , , ,14,10,4
2004,Riverside County,5815,4420,2547,1873,58,43,15,5815,4420,2547,1873,58,43,15,2878,1516,1362,1484,988,496, , , ,474,173,71,139,91,169,86,30,36,17,752,282,470
2004,Sacramento County,15836,14553,10201,4352,1056,864,192,4754,3471,2313,1158,56,41,15,2226,1482,744,1189,790,399,10082,7065,3017,427,165,49,95,118,148,96,25,22,5,708,601,107
2004,San Benito County,119,91,54,37, , , ,119,91,54,37, , , ,55,24,31,36,30,6, , , ,9,4,1,3,1, , , , , ,19,14,5
2004,San Bernardino County,6283,4610,2750,1860,143,64,79,6283,4610,2750,1860,143,64,79,2719,1508,1211,1748,1178,570, , , ,432,201,51,139,41,169,91,23,49,6,1072,362,710
2004,San Diego County,10564,8138,5435,2703,288,199,89,10564,8138,5435,2703,288,199,89,3656,2219,1437,4194,3017,1177, , , ,893,283,168,250,192,327,184,54,58,31,1206,913,293
2004,San Francisco County,3943,3553,3030,523,105,67,38,3943,3553,3030,523,105,67,38,920,802,118,2528,2161,367, , , ,250,119,44,25,62,140,88,17,28,7, , , 
2004,San Joaquin County,2245,1651,925,726,20,15,5,2245,1651,925,726,20,15,5,692,281,411,939,629,310, , , ,200,80,51,41,28,86,52,16,16,2,308,116,192
2004,San Luis Obispo County,1061,808,491,317,164,133,31,1061,808,491,317,164,133,31,352,146,206,292,212,80, , , ,96,33,15,20,28, , , , , ,157,106,51
2004,San Mateo County,2228,1685,1225,460, , , ,2228,1685,1225,460, , , ,553,407,146,1132,818,314, , , ,124,55,11,37,21, , , , , ,419,304,115
2004,Santa Barbara County,1723,1115,612,503,60,31,29,1723,1115,612,503,60,31,29,619,278,341,436,303,133, , , ,140,50,22,42,26,72,35,10,20,7,396,263,133
2004,Santa Clara County,5156,3697,2755,942,103,53,50,5156,3697,2755,942,103,53,50,671,518,153,2923,2184,739, , , ,471,197,98,96,80,205,109,29,40,27,783,301,482
2004,Santa Cruz County,809,607,361,246,43,18,25,809,607,361,246,43,18,25,295,144,151,269,199,70, , , ,84,33,15,24,12, , , , , ,118,68,50
2004,Shasta County,609,424,253,171, , , ,609,424,253,171, , , ,234,124,110,190,129,61, , , ,77,23,17,23,14, , , , , ,108,41,67
2004,Sierra County,23,16,10,6, , , ,23,16,10,6, , , ,16,10,6, , , , , , ,2,1,0,1,0, , , , , ,5,3,2
2004,Siskiyou County,253,187,133,54, , , ,253,187,133,54, , , ,121,92,29,66,41,25, , , ,27,9,5,5,8,6,5,0,1,0,33,17,16
2004,Solano County,1525,1089,563,526,7,6,1,1525,1089,563,526,7,6,1,429,105,324,653,452,201, , , ,128,59,13,44,12,71,45,8,18,0,237,189,48
2004,Sonoma County,1633,1205,637,568,40,25,15,1633,1205,637,568,40,25,15,656,270,386,509,342,167, , , ,100,37,17,43,3,47,27,8,11,1,281,116,165
2004,Stanislaus County,1649,1263,661,602,20,11,9,1649,1263,661,602,20,11,9,622,217,405,621,433,188, , , ,121,47,16,39,19,39,24,2,9,4,226,171,55
2004,Sutter County,268,208,154,54, , , ,268,208,154,54, , , ,135,107,28,73,47,26, , , ,24,8,10,5,1, , , , , ,36,29,7
2004,Tehama County,228,146,102,44, , , ,228,146,102,44, , , ,89,65,24,57,37,20, , , ,23,7,5,8,3, , , , , ,59,27,32
2004,Trinity County,61,34,19,15, , , ,61,34,19,15, , , ,34,19,15, , , , , , ,10,4,2,2,2, , , , , ,17,8,9
2004,Tulare County,1594,1042,743,299,6,5,1,1594,1042,743,299,6,5,1,657,467,190,379,271,108, , , ,183,61,45,39,38,65,34,9,10,12,304,100,204
2004,Tuolumne County,212,158,85,73, , , ,212,158,85,73, , , ,140,71,69,18,14,4, , , ,21,7,2,7,5,7,4,1,2,0,26,13,13
2004,Ventura County,2697,1954,1256,698,18,12,6,2697,1954,1256,698,18,12,6,1138,714,424,798,530,268, , , ,244,84,59,54,47,76,49,10,11,6,423,331,92
2004,Yolo County,795,581,310,271,69,42,27,795,581,310,271,69,42,27,233,79,154,279,189,90, , , ,95,31,27,22,15,32,22,4,6,0,87,33,54
2004,Yuba County,338,195,152,43, , , ,338,195,152,43, , , ,155,123,32,40,29,11, , , ,15,9,3,2,1, , , , , ,128,38,90
2005,Alameda County,5609,4490,2953,1537,248,141,107,5609,4490,2953,1537,248,141,107,1519,962,557,2723,1850,873, , , ,340,157,68,115,0,187,115,21,41,10,592,210,382
2005,Alpine County,19,15,12,3, , , ,19,15,12,3, , , ,15,12,3, , , , , , ,2,1,0,1,0, , , , , ,2,1,1
2005,Amador County,157,109,66,43, , , ,157,109,66,43, , , ,83,44,39,26,22,4, , , ,31,9,11,8,3, , , , , ,17,12,5
2005,Butte County,738,496,265,231,24,16,8,738,496,265,231,24,16,8,234,94,140,238,155,83, , , ,92,26,27,31,8, , , , , ,150,50,100
2005,Calaveras County,146,114,67,47, , , ,146,114,67,47, , , ,104,58,46,10,9,1, , , ,16,7,2,5,2, , , , , ,16,12,4
2005,Colusa County,98,78,49,29, , , ,98,78,49,29, , , ,59,32,27,19,17,2, , , ,7,2,2,2,1, , , , , ,13,7,6
2005,Contra Costa County,3242,2527,1757,770,306,205,101,2965,2250,1571,679,29,19,10,1011,684,327,1210,868,342, , , ,197,97,23,55,22,135,87,10,20,18,383,169,214
2005,Del Norte County,112,72,41,31, , , ,112,72,41,31, , , ,60,30,30,12,11,1, , , ,13,5,3,4,1, , , , , ,27,6,21
2005,El Dorado County,641,482,251,231, , , ,641,482,251,231, , , ,393,193,200,89,58,31, , , ,51,18,9,15,9,19,12,2,5,0,89,66,23
2005,Fresno County,3649,2723,1573,1150,38,28,10,3649,2723,1573,1150,38,28,10,1127,475,652,1558,1070,488, , , ,257,111,58,63,25,111,69,12,22,8,558,153,405
2005,Glenn County,119,84,48,36, , , ,119,84,48,36, , , ,61,28,33,23,20,3, , , ,8,3,1,4,0, , , , , ,27,9,18
2005,Humboldt County,575,384,282,102,20,11,9,575,384,282,102,20,11,9,225,176,49,139,95,44, , , ,49,13,8,18,10,30,17,4,9,0,112,81,31
2005,Imperial County,674,453,313,140, , , ,674,453,313,140, , , ,247,163,84,206,150,56, , , ,47,18,10,17,2,24,14,4,6,0,150,60,90
2005,Inyo County,138,87,62,25, , , ,138,87,62,25, , , ,70,51,19,17,11,6, , , ,13,4,3,4,2, , , , , ,38,12,26
2005,Kern County,2518,1735,940,795,13,10,3,2518,1735,940,795,13,10,3,1063,479,584,659,451,208, , , ,160,71,41,40,8,81,52,11,16,2,542,230,312
2005,Kings County,495,322,173,149, , , ,495,322,173,149, , , ,196,80,116,126,93,33, , , ,47,19,11,13,4, , , , , ,126,48,78
2005,Lake County,267,193,99,94, , , ,267,193,99,94, , , ,146,62,84,47,37,10, , , ,29,14,6,9,0, , , , , ,45,24,21
2005,Lassen County,147,107,84,23, , , ,147,107,84,23, , , ,87,66,21,20,18,2, , , ,9,4,1,3,1,5,3,0,2,0,26,12,14
2005,Los Angeles County,41701,33790,22553,11237,257,171,86,41701,33790,22553,11237,257,171,86,13939,8188,5751,19594,14194,5400, , , ,1960,952,236,582,190,987,677,73,157,80,4964,2332,2632
2005,Madera County,337,200,143,57, , , ,337,200,143,57, , , ,100,66,34,100,77,23, , , ,30,13,7,8,2, , , , , ,107,45,62
2005,Marin County,902,658,468,190,8,6,2,902,658,468,190,8,6,2,316,209,107,334,253,81, , , ,95,37,11,32,15,46,27,4,12,3,103,58,45
2005,Mariposa County,88,68,54,14, , , ,88,68,54,14, , , ,68,54,14, , , , , , ,8,3,1,3,1, , , , , ,12,8,4
2005,Mendocino County,380,229,174,55, , , ,380,229,174,55, , , ,155,120,35,74,54,20, , , ,52,17,8,17,10,19,12,3,3,1,80,38,42
2005,Merced County,735,499,372,127, , , ,735,499,372,127, , , ,237,187,50,262,185,77, , , ,73,21,16,24,12,16,12,0,4,0,147,53,94
2005,Modoc County,43,33,28,5, , , ,43,33,28,5, , , ,23,19,4,10,9,1, , , ,5,1,1,2,1, , , , , ,5,3,2
2005,Mono County,82,68,46,22, , , ,82,68,46,22, , , ,43,26,17,25,20,5, , , ,7,3,1,2,1, , , , , ,7,5,2
2005,Monterey County,1394,971,739,232,24,21,3,1394,971,739,232,24,21,3,430,325,105,517,393,124, , , ,123,49,31,40,3,44,24,7,11,2,256,178,78
2005,Napa County,525,361,271,90,100,94,6,525,361,271,90,100,94,6,113,85,28,148,92,56, , , ,49,22,9,15,3,22,14,2,5,1,93,39,54
2005,Nevada County,362,261,126,135, , , ,362,261,126,135, , , ,186,69,117,75,57,18, , , ,28,12,2,14,0,12,8,0,4,0,61,21,40
2005,Orange County,9640,7283,4381,2902,68,49,19,9640,7283,4381,2902,68,49,19,3258,1700,1558,3957,2632,1325, , , ,648,249,144,136,119,378,204,70,61,43,1331,379,952
2005,Placer County,954,717,432,285, , , ,954,717,432,285, , , ,386,210,176,331,222,109, , , ,101,35,13,51,2, , , , , ,136,102,34
2005,Plumas County,95,70,35,35, , , ,95,70,35,35, , , ,70,35,35, , , , , , ,10,3,3,2,2, , , , , ,15,10,5
2005,Riverside County,6006,4607,2709,1898,58,43,15,6006,4607,2709,1898,58,43,15,3033,1641,1392,1516,1025,491, , , ,496,176,74,148,98,174,94,31,28,21,729,263,466
2005,Sacramento County,15695,14349,10085,4264,1038,869,169,4733,3387,2304,1083,54,41,13,2165,1482,683,1168,781,387,9978,6953,3025,433,168,48,94,123,148,96,25,22,5,765,624,141
2005,San Benito County,123,94,56,38, , , ,123,94,56,38, , , ,60,27,33,34,29,5, , , ,9,4,1,3,1, , , , , ,20,16,4
2005,San Bernardino County,6640,4906,2855,2051,166,62,104,6640,4906,2855,2051,166,62,104,2930,1573,1357,1810,1220,590, , , ,453,206,51,148,48,177,106,23,43,5,1104,369,735
2005,San Diego County,10648,8179,5399,2780,284,207,77,10648,8179,5399,2780,284,207,77,3620,2122,1498,4275,3070,1205, , , ,913,300,170,252,191,309,182,43,51,33,1247,936,311
2005,San Francisco County,4400,3645,3068,577,163,79,84,4400,3645,3068,577,163,79,84,929,796,133,2553,2193,360, , , ,254,127,40,25,62,142,88,17,30,7,359,153,206
2005,San Joaquin County,2269,1681,940,741,20,16,4,2269,1681,940,741,20,16,4,698,282,416,963,642,321, , , ,204,82,46,49,27,86,52,16,16,2,298,111,187
2005,San Luis Obispo County,1048,800,506,294,182,153,29,1048,800,506,294,182,153,29,332,144,188,286,209,77, , , ,88,33,15,18,22, , , , , ,160,108,52
2005,San Mateo County,2242,1689,1179,510, , , ,2242,1689,1179,510, , , ,556,363,193,1133,816,317, , , ,124,55,11,37,21, , , , , ,429,320,109
2005,Santa Barbara County,1732,1127,601,526,65,36,29,1732,1127,601,526,65,36,29,625,265,360,437,300,137, , , ,140,49,23,42,26,72,34,10,22,6,393,265,128
2005,Santa Clara County,5249,3727,2732,995,102,52,50,5249,3727,2732,995,102,52,50,681,494,187,2944,2186,758, , , ,497,184,95,91,127,206,109,29,34,34,819,304,515
2005,Santa Cruz County,800,605,353,252,43,18,25,800,605,353,252,43,18,25,300,142,158,262,193,69, , , ,81,33,15,21,12, , , , , ,114,85,29
2005,Shasta County,593,420,236,184, , , ,593,420,236,184, , , ,229,105,124,191,131,60, , , ,65,23,11,19,12, , , , , ,108,42,66
2005,Sierra County,21,15,10,5, , , ,21,15,10,5, , , ,15,10,5, , , , , , ,2,1,0,1,0, , , , , ,4,3,1
2005,Siskiyou County,254,193,138,55, , , ,254,193,138,55, , , ,128,96,32,65,42,23, , , ,25,8,5,4,8,4,3,0,1,0,32,15,17
2005,Solano County,1577,1101,560,541,7,6,1,1577,1101,560,541,7,6,1,438,107,331,656,447,209, , , ,123,56,10,41,16,82,50,9,23,0,271,204,67
2005,Sonoma County,1716,1235,650,585,42,22,20,1716,1235,650,585,42,22,20,653,273,380,540,355,185, , , ,104,43,15,43,3,47,27,8,11,1,330,103,227
2005,Stanislaus County,1630,1229,685,544,20,11,9,1630,1229,685,544,20,11,9,590,233,357,619,441,178, , , ,135,50,21,41,23,44,27,3,11,3,222,171,51
2005,Sutter County,259,197,149,48, , , ,259,197,149,48, , , ,124,99,25,73,50,23, , , ,24,8,8,5,3, , , , , ,38,32,6
2005,Tehama County,246,164,115,49, , , ,246,164,115,49, , , ,106,78,28,58,37,21, , , ,24,8,5,8,3, , , , , ,58,24,34
2005,Trinity County,65,39,20,19, , , ,65,39,20,19, , , ,39,20,19, , , , , , ,9,3,2,2,2, , , , , ,17,8,9
2005,Tulare County,1609,1070,760,310,6,5,1,1609,1070,760,310,6,5,1,640,451,189,424,304,120, , , ,169,60,44,35,30,69,35,10,11,13,301,99,202
2005,Tuolumne County,210,150,84,66, , , ,210,150,84,66, , , ,131,69,62,19,15,4, , , ,22,7,3,7,5,7,4,1,2,0,31,17,14
2005,Ventura County,2658,1903,1228,675,19,14,5,2658,1903,1228,675,19,14,5,1095,681,414,789,533,256, , , ,234,81,56,49,48,76,49,10,11,6,445,343,102
2005,Yolo County,837,598,318,280,69,40,29,837,598,318,280,69,40,29,232,82,150,297,196,101, , , ,95,30,27,22,16,32,22,4,6,0,112,36,76
2005,Yuba County,326,202,152,50, , , ,326,202,152,50, , , ,162,123,39,40,29,11, , , ,17,10,3,3,1, , , , , ,107,33,74
2006,Alameda County,5632,4530,2911,1619,248,145,103,5632,4530,2911,1619,248,145,103,1535,935,600,2747,1831,916, , , ,339,151,66,100,22,179,113,20,40,6,584,199,385
2006,Alpine County,21,16,12,4, , , ,21,16,12,4, , , ,16,12,4, , , , , , ,3,1,0,2,0, , , , , ,2,1,1
2006,Amador County,170,118,69,49, , , ,170,118,69,49, , , ,91,45,46,27,24,3, , , ,34,10,14,9,1, , , , , ,18,12,6
2006,Butte County,792,551,295,256,28,17,11,792,551,295,256,28,17,11,269,108,161,254,170,84, , , ,91,26,27,30,8, , , , , ,150,59,91
2006,Calaveras County,140,111,65,46, , , ,140,111,65,46, , , ,101,56,45,10,9,1, , , ,16,7,2,6,1, , , , , ,13,9,4
2006,Colusa County,103,76,45,31, , , ,103,76,45,31, , , ,57,29,28,19,16,3, , , ,9,2,2,4,1, , , , , ,18,11,7
2006,Contra Costa County,3211,2545,1783,762,300,197,103,2942,2276,1607,669,31,21,10,1032,711,321,1213,875,338, , , ,154,87,18,35,14,135,87,10,20,18,377,140,237
2006,Del Norte County,113,70,40,30, , , ,113,70,40,30, , , ,58,29,29,12,11,1, , , ,13,6,3,4,0, , , , , ,30,9,21
2006,El Dorado County,669,457,248,209, , , ,669,457,248,209, , , ,368,192,176,89,56,33, , , ,59,20,11,15,13,30,22,2,6,0,123,99,24
2006,Fresno County,3713,2790,1607,1183,43,30,13,3713,2790,1607,1183,43,30,13,1126,489,637,1621,1088,533, , , ,264,114,60,69,21,111,69,12,22,8,548,424,124
2006,Glenn County,128,92,48,44, , , ,128,92,48,44, , , ,68,28,40,24,20,4, , , ,9,3,2,4,0, , , , , ,27,9,18
2006,Humboldt County,592,388,278,110,21,10,11,592,388,278,110,21,10,11,223,171,52,144,97,47, , , ,55,16,9,20,10,30,17,4,9,0,119,87,32
2006,Imperial County,651,473,332,141, , , ,651,473,332,141, , , ,256,174,82,217,158,59, , , ,44,15,10,17,2,24,14,4,6,0,110,53,57
2006,Inyo County,139,89,64,25, , , ,139,89,64,25, , , ,70,51,19,19,13,6, , , ,13,4,3,4,2, , , , , ,37,12,25
2006,Kern County,2624,1813,964,849,15,11,4,2624,1813,964,849,15,11,4,1099,480,619,699,473,226, , , ,161,67,41,45,8,81,53,12,14,2,569,239,330
2006,Kings County,506,343,187,156, , , ,506,343,187,156, , , ,208,86,122,135,101,34, , , ,41,18,9,11,3, , , , , ,122,46,76
2006,Lake County,258,186,92,94, , , ,258,186,92,94, , , ,143,56,87,43,36,7, , , ,27,11,7,8,1, , , , , ,45,24,21
2006,Lassen County,157,110,87,23, , , ,157,110,87,23, , , ,91,70,21,19,17,2, , , ,12,4,2,4,2,5,3,0,1,1,30,12,18
2006,Los Angeles County,42886,34507,22820,11687,275,171,104,42886,34507,22820,11687,275,171,104,14340,8459,5881,19892,14190,5702, , , ,2032,957,271,532,272,990,685,68,160,77,5357,2349,3008
2006,Madera County,345,208,149,59, , , ,345,208,149,59, , , ,107,76,31,101,73,28, , , ,32,15,7,8,2, , , , , ,105,45,60
2006,Marin County,897,643,454,189,6,5,1,897,643,454,189,6,5,1,305,199,106,332,250,82, , , ,92,37,9,32,14,46,27,4,12,3,116,60,56
2006,Mariposa County,92,71,57,14, , , ,92,71,57,14, , , ,71,57,14, , , , , , ,8,3,1,3,1, , , , , ,13,8,5
2006,Mendocino County,403,248,184,64, , , ,403,248,184,64, , , ,171,129,42,77,55,22, , , ,52,17,7,20,8,21,14,3,3,1,82,40,42
2006,Merced County,783,540,399,141,15,8,7,783,540,399,141,15,8,7,238,189,49,287,202,85, , , ,75,23,16,28,8,18,13,0,5,0,150,55,95
2006,Modoc County,43,32,28,4, , , ,43,32,28,4, , , ,25,22,3,7,6,1, , , ,5,1,1,2,1, , , , , ,6,4,2
2006,Mono County,84,69,47,22, , , ,84,69,47,22, , , ,43,26,17,26,21,5, , , ,8,4,1,2,1, , , , , ,7,5,2
2006,Monterey County,1405,948,717,231,23,20,3,1405,948,717,231,23,20,3,418,312,106,507,385,122, , , ,124,49,28,44,3,43,25,7,9,2,290,202,88
2006,Napa County,528,360,269,91,94,88,6,528,360,269,91,94,88,6,122,88,34,144,93,51, , , ,45,20,8,15,2,24,15,3,5,1,99,42,57
2006,Nevada County,356,258,126,132, , , ,356,258,126,132, , , ,186,70,116,72,56,16, , , ,25,11,2,11,1,13,9,0,4,0,60,21,39
2006,Orange County,9938,7521,4413,3108,70,47,23,9938,7521,4413,3108,70,47,23,3396,1695,1701,4055,2671,1384, , , ,642,247,130,120,145,387,207,75,61,44,1388,405,983
2006,Placer County,1031,780,443,337, , , ,1031,780,443,337, , , ,424,207,217,356,236,120, , , ,112,42,11,57,2, , , , , ,139,105,34
2006,Plumas County,95,70,35,35, , , ,95,70,35,35, , , ,70,35,35, , , , , , ,10,3,3,2,2, , , , , ,15,10,5
2006,Riverside County,6712,5016,2949,2067,53,40,13,6712,5016,2949,2067,53,40,13,3342,1818,1524,1621,1091,530, , , ,638,238,106,190,104,224,119,40,33,32,834,313,521
2006,Sacramento County,15777,14359,9959,4400,1033,867,166,4904,3486,2330,1156,61,45,16,2003,1392,611,1422,893,529,9901,6807,3094,468,182,52,104,130,156,102,25,24,5,794,646,148
2006,San Benito County,128,99,59,40, , , ,128,99,59,40, , , ,65,30,35,34,29,5, , , ,9,4,1,3,1, , , , , ,20,16,4
2006,San Bernardino County,7074,5206,3052,2154,141,67,74,7074,5206,3052,2154,141,67,74,3246,1761,1485,1819,1224,595, , , ,473,217,63,136,57,197,108,27,56,6,1198,372,826
2006,San Diego County,10690,8175,5270,2905,284,203,81,10690,8175,5270,2905,284,203,81,3679,2112,1567,4212,2955,1257, , , ,915,298,166,245,206,324,198,47,52,27,1276,962,314
2006,San Francisco County,4408,3631,3067,564,160,75,85,4408,3631,3067,564,160,75,85,930,790,140,2541,2202,339, , , ,268,130,42,26,70,148,90,17,34,7,361,165,196
2006,San Joaquin County,2332,1719,968,751,21,15,6,2332,1719,968,751,21,15,6,717,289,428,981,664,317, , , ,227,89,51,54,33,90,55,16,16,3,296,110,186
2006,San Luis Obispo County,1070,822,500,322,172,143,29,1070,822,500,322,172,143,29,354,150,204,296,207,89, , , ,85,33,15,18,19, , , , , ,163,108,55
2006,San Mateo County,2356,1760,1261,499, , , ,2356,1760,1261,499, , , ,640,442,198,1120,819,301, , , ,128,55,11,38,24, , , , , ,468,171,297
2006,Santa Barbara County,1773,1166,651,515,63,32,31,1773,1166,651,515,63,32,31,667,314,353,436,305,131, , , ,142,51,23,42,26,71,34,10,21,6,394,263,131
2006,Santa Clara County,5295,3756,2732,1024,119,55,64,5295,3756,2732,1024,119,55,64,683,487,196,2954,2190,764, , , ,494,186,92,106,110,200,102,26,66,6,845,304,541
2006,Santa Cruz County,808,600,341,259,43,16,27,808,600,341,259,43,16,27,298,134,164,259,191,68, , , ,85,33,13,25,14, , , , , ,123,91,32
2006,Shasta County,584,393,243,150, , , ,584,393,243,150, , , ,194,106,88,199,137,62, , , ,70,24,14,17,15, , , , , ,121,51,70
2006,Sierra County,22,15,11,4, , , ,22,15,11,4, , , ,15,11,4, , , , , , ,3,1,1,1,0, , , , , ,4,3,1
2006,Siskiyou County,267,192,139,53, , , ,267,192,139,53, , , ,131,99,32,61,40,21, , , ,28,8,6,6,8,8,5,0,3,0,39,17,22
2006,Solano County,1612,1131,569,562,7,6,1,1612,1131,569,562,7,6,1,450,110,340,674,453,221, , , ,124,56,10,47,11,81,50,8,22,1,276,211,65
2006,Sonoma County,1677,1264,682,582,45,25,20,1677,1264,682,582,45,25,20,672,289,383,547,368,179, , , ,108,43,14,48,3,49,29,8,11,1,256,92,164
2006,Stanislaus County,1654,1252,931,321,22,11,11,1654,1252,931,321,22,11,11,592,467,125,638,453,185, , , ,142,53,21,43,25,45,28,3,12,2,215,179,36
2006,Sutter County,279,219,161,58, , , ,279,219,161,58, , , ,125,98,27,94,63,31, , , ,25,11,8,5,1, , , , , ,35,30,5
2006,Tehama County,243,164,113,51, , , ,243,164,113,51, , , ,104,75,29,60,38,22, , , ,21,6,5,7,3, , , , , ,58,24,34
2006,Trinity County,71,38,18,20, , , ,71,38,18,20, , , ,38,18,20, , , , , , ,9,3,2,2,2, , , , , ,24,10,14
2006,Tulare County,1700,1126,816,310,6,5,1,1700,1126,816,310,6,5,1,694,499,195,426,312,114, , , ,181,62,46,38,35,76,39,11,12,14,317,101,216
2006,Tuolumne County,212,150,79,71, , , ,212,150,79,71, , , ,132,65,67,18,14,4, , , ,22,7,3,7,5,7,4,1,2,0,33,19,14
2006,Ventura County,2780,2031,1297,734,36,31,5,2780,2031,1297,734,36,31,5,1216,733,483,779,533,246, , , ,233,80,56,47,50,78,49,10,11,8,438,338,100
2006,Yolo County,874,620,330,290,67,41,26,874,620,330,290,67,41,26,252,91,161,301,198,103, , , ,98,33,32,20,13,33,22,4,7,0,123,42,81
2006,Yuba County,334,211,159,52, , , ,334,211,159,52, , , ,170,129,41,41,30,11, , , ,17,10,3,3,1, , , , , ,106,35,71
2007,Alameda County,5770,4649,2968,1681,232,144,88,5770,4649,2968,1681,232,144,88,1612,967,645,2805,1857,948, , , ,335,148,64,98,25,182,115,20,37,10,604,242,362
2007,Alpine County,25,20,15,5, , , ,25,20,15,5, , , ,20,15,5, , , , , , ,3,1,0,2,0, , , , , ,2,1,1
2007,Amador County,162,114,69,45, , , ,162,114,69,45, , , ,88,45,43,26,24,2, , , ,28,8,10,9,1, , , , , ,20,13,7
2007,Butte County,793,555,292,263,29,19,10,793,555,292,263,29,19,10,280,112,168,246,161,85, , , ,86,26,26,26,8, , , , , ,152,64,88
2007,Calaveras County,156,121,73,48, , , ,156,121,73,48, , , ,111,64,47,10,9,1, , , ,18,8,3,6,1, , , , , ,17,12,5
2007,Colusa County,106,80,49,31, , , ,106,80,49,31, , , ,59,31,28,21,18,3, , , ,9,2,2,3,2, , , , , ,17,10,7
2007,Contra Costa County,3338,2623,1856,767,315,219,96,3057,2342,1660,682,34,23,11,1005,674,331,1303,963,340, , , ,169,95,20,40,14,131,79,10,19,23,415,166,249
2007,Del Norte County,119,75,45,30, , , ,119,75,45,30, , , ,62,32,30,13,13,0, , , ,12,4,4,3,1, , , , , ,32,11,21
2007,El Dorado County,690,458,248,210, , , ,690,458,248,210, , , ,372,196,176,86,52,34, , , ,73,25,19,18,11,32,24,2,5,1,127,99,28
2007,Fresno County,3919,2916,1637,1279,44,33,11,3919,2916,1637,1279,44,33,11,1197,487,710,1675,1117,558, , , ,295,134,65,75,21,125,76,18,23,8,583,444,139
2007,Glenn County,128,95,51,44, , , ,128,95,51,44, , , ,68,29,39,27,22,5, , , ,10,3,2,4,1, , , , , ,23,9,14
2007,Humboldt County,586,386,274,112,19,11,8,586,386,274,112,19,11,8,216,164,52,151,99,52, , , ,54,16,9,20,9,30,17,4,9,0,116,84,32
2007,Imperial County,661,483,336,147, , , ,661,483,336,147, , , ,261,177,84,222,159,63, , , ,49,21,10,15,3,24,14,4,6,0,105,53,52
2007,Inyo County,140,90,65,25, , , ,140,90,65,25, , , ,70,51,19,20,14,6, , , ,13,4,3,4,2, , , , , ,37,12,25
2007,Kern County,2579,1827,986,841,15,11,4,2579,1827,986,841,15,11,4,1083,476,607,729,499,230, , , ,178,75,46,50,7,89,54,13,19,3,485,209,276
2007,Kings County,520,351,175,176, , , ,520,351,175,176, , , ,221,81,140,130,94,36, , , ,47,19,12,13,3, , , , , ,122,50,72
2007,Lake County,276,196,92,104, , , ,276,196,92,104, , , ,150,57,93,46,35,11, , , ,32,13,8,9,2, , , , , ,48,24,24
2007,Lassen County,161,109,85,24, , , ,161,109,85,24, , , ,91,69,22,18,16,2, , , ,11,4,1,4,2,7,3,1,2,1,34,14,20
2007,Los Angeles County,44602,36100,23928,12172,298,181,117,44602,36100,23928,12172,298,181,117,15651,9278,6373,20151,14469,5682, , , ,2101,1016,277,504,304,1040,716,74,153,97,5361,2505,2856
2007,Madera County,372,215,153,62, , , ,372,215,153,62, , , ,110,76,34,105,77,28, , , ,38,17,9,10,2, , , , , ,119,53,66
2007,Marin County,918,673,477,196,7,6,1,918,673,477,196,7,6,1,316,209,107,350,262,88, , , ,91,37,9,31,14,46,27,4,12,3,108,57,51
2007,Mariposa County,98,75,60,15, , , ,98,75,60,15, , , ,75,60,15, , , , , , ,8,3,1,3,1, , , , , ,15,8,7
2007,Mendocino County,403,242,180,62, , , ,403,242,180,62, , , ,163,127,36,79,53,26, , , ,52,17,7,20,8,27,17,4,3,3,82,40,42
2007,Merced County,829,580,430,150,16,9,7,829,580,430,150,16,9,7,255,199,56,309,222,87, , , ,74,25,16,24,9,18,13,0,5,0,157,62,95
2007,Modoc County,46,33,28,5, , , ,46,33,28,5, , , ,26,22,4,7,6,1, , , ,7,2,1,2,2, , , , , ,6,4,2
2007,Mono County,85,69,48,21, , , ,85,69,48,21, , , ,43,26,17,26,22,4, , , ,8,4,1,2,1, , , , , ,8,6,2
2007,Monterey County,1458,1002,757,245,23,20,3,1458,1002,757,245,23,20,3,431,317,114,548,420,128, , , ,125,50,28,44,3,48,27,7,12,2,283,195,88
2007,Napa County,536,368,284,84,102,98,4,536,368,284,84,102,98,4,123,93,30,143,93,50, , , ,45,20,8,15,2,23,14,3,5,1,100,43,57
2007,Nevada County,368,269,134,135, , , ,368,269,134,135, , , ,191,71,120,78,63,15, , , ,26,11,2,12,1,13,9,0,4,0,60,20,40
2007,Orange County,10302,7770,4524,3246,75,54,21,10302,7770,4524,3246,75,54,21,3555,1753,1802,4140,2717,1423, , , ,724,272,194,111,147,407,222,75,61,49,1401,401,1000
2007,Placer County,1055,803,499,304, , , ,1055,803,499,304, , , ,441,259,182,362,240,122, , , ,112,41,12,54,5, , , , , ,140,106,34
2007,Plumas County,94,73,38,35, , , ,94,73,38,35, , , ,73,38,35, , , , , , ,10,3,3,3,1, , , , , ,11,7,4
2007,Riverside County,7193,5341,3121,2220,58,42,16,7193,5341,3121,2220,58,42,16,3640,1965,1675,1643,1114,529, , , ,749,244,127,249,129,249,135,42,38,34,854,317,537
2007,Sacramento County,17208,15716,10719,4997,934,792,142,5366,3874,2505,1369,67,47,20,2296,1419,877,1511,1039,472,10975,7469,3506,481,186,52,103,140,155,107,24,18,6,856,689,167
2007,San Benito County,134,101,60,41, , , ,134,101,60,41, , , ,67,32,35,34,28,6, , , ,11,5,1,4,1, , , , , ,22,17,5
2007,San Bernardino County,7386,5423,3127,2296,135,59,76,7386,5423,3127,2296,135,59,76,3378,1783,1595,1910,1285,625, , , ,499,227,72,145,55,214,117,28,56,13,1250,376,874
2007,San Diego County,10897,8299,5393,2906,299,214,85,10897,8299,5393,2906,299,214,85,3791,2191,1600,4209,2988,1221, , , ,967,318,173,252,224,343,205,47,66,25,1288,969,319
2007,San Francisco County,4665,3853,3241,612,169,73,96,4665,3853,3241,612,169,73,96,1005,831,174,2679,2337,342, , , ,272,134,41,20,77,159,93,18,30,18,381,175,206
2007,San Joaquin County,2437,1777,977,800,25,19,6,2437,1777,977,800,25,19,6,737,296,441,1015,662,353, , , ,257,97,55,57,48,95,58,18,16,3,308,123,185
2007,San Luis Obispo County,1118,854,511,343,166,134,32,1118,854,511,343,166,134,32,383,162,221,305,215,90, , , ,93,34,15,24,20, , , , , ,171,114,57
2007,San Mateo County,2356,1760,1260,500, , , ,2356,1760,1260,500, , , ,633,433,200,1127,827,300, , , ,130,55,12,38,25, , , , , ,466,208,258
2007,Santa Barbara County,1796,1194,639,555,64,36,28,1796,1194,639,555,64,36,28,688,309,379,442,294,148, , , ,142,51,23,42,26,68,34,10,18,6,392,263,129
2007,Santa Clara County,5396,3808,2804,1004,102,53,49,5396,3808,2804,1004,102,53,49,692,517,175,3014,2234,780, , , ,530,185,91,147,107,207,107,28,40,32,851,304,547
2007,Santa Cruz County,827,609,342,267,46,19,27,827,609,342,267,46,19,27,312,137,175,251,186,65, , , ,86,35,13,25,13, , , , , ,132,98,34
2007,Shasta County,646,438,284,154, , , ,646,438,284,154, , , ,237,147,90,201,137,64, , , ,80,24,18,16,22, , , , , ,128,54,74
2007,Sierra County,22,15,11,4, , , ,22,15,11,4, , , ,15,11,4, , , , , , ,2,1,0,1,0, , , , , ,5,4,1
2007,Siskiyou County,267,194,143,51, , , ,267,194,143,51, , , ,131,99,32,63,44,19, , , ,26,7,6,5,8,7,4,0,3,0,40,16,24
2007,Solano County,1704,1191,599,592,6,4,2,1704,1191,599,592,6,4,2,480,118,362,705,477,228, , , ,137,62,12,47,16,86,53,8,24,1,290,225,65
2007,Sonoma County,1749,1320,929,391,43,23,20,1749,1320,929,391,43,23,20,729,534,195,548,372,176, , , ,111,48,15,44,4,51,30,9,11,1,267,106,161
2007,Stanislaus County,1711,1294,713,581,22,11,11,1711,1294,713,581,22,11,11,616,233,383,656,469,187, , , ,134,47,21,38,28,50,32,5,12,1,233,209,24
2007,Sutter County,295,231,167,64, , , ,295,231,167,64, , , ,129,100,29,102,67,35, , , ,26,11,9,5,1, , , , , ,38,31,7
2007,Tehama County,239,164,109,55, , , ,239,164,109,55, , , ,105,72,33,59,37,22, , , ,24,7,7,7,3, , , , , ,51,20,31
2007,Trinity County,73,41,20,21, , , ,73,41,20,21, , , ,41,20,21, , , , , , ,9,3,2,2,2, , , , , ,23,8,15
2007,Tulare County,1789,1191,804,387,5,4,1,1789,1191,804,387,5,4,1,711,450,261,475,350,125, , , ,188,67,46,39,36,82,42,11,14,15,328,112,216
2007,Tuolumne County,211,149,77,72, , , ,211,149,77,72, , , ,128,60,68,21,17,4, , , ,24,8,4,7,5,7,4,1,2,0,31,17,14
2007,Ventura County,2830,2076,1321,755,48,27,21,2830,2076,1321,755,48,27,21,1224,748,476,804,546,258, , , ,236,86,53,47,50,87,54,12,12,9,431,329,102
2007,Yolo County,920,633,332,301,71,41,30,920,633,332,301,71,41,30,260,87,173,302,204,98, , , ,104,38,34,20,12,35,24,4,7,0,148,48,100
2007,Yuba County,339,213,165,48, , , ,339,213,165,48, , , ,174,137,37,39,28,11, , , ,18,11,3,3,1, , , , , ,108,35,73
2008,Alameda County,5820,4662,3074,1588,218,137,81,5820,4662,3074,1588,218,137,81,1682,1037,645,2762,1900,862, , , ,344,151,63,101,29,179,114,20,34,11,635,267,368
2008,Alpine County,23,18,15,3, , , ,23,18,15,3, , , ,18,15,3, , , , , , ,3,1,0,2,0, , , , , ,2,1,1
2008,Amador County,162,116,72,44, , , ,162,116,72,44, , , ,90,48,42,26,24,2, , , ,26,9,7,9,1, , , , , ,20,12,8
2008,Butte County,781,551,286,265,27,17,10,781,551,286,265,27,17,10,281,113,168,243,156,87, , , ,87,28,26,24,9, , , , , ,143,57,86
2008,Calaveras County,155,120,69,51, , , ,155,120,69,51, , , ,110,60,50,10,9,1, , , ,18,8,3,6,1, , , , , ,17,12,5
2008,Colusa County,111,85,49,36, , , ,111,85,49,36, , , ,64,31,33,21,18,3, , , ,9,2,2,3,2, , , , , ,17,10,7
2008,Contra Costa County,3325,2686,1894,792,321,227,94,3041,2402,1692,710,37,25,12,1004,681,323,1361,986,375, , , ,172,95,22,46,9,112,69,10,17,16,355,191,164
2008,Del Norte County,125,79,46,33, , , ,125,79,46,33, , , ,65,33,32,14,13,1, , , ,12,5,3,3,1, , , , , ,34,11,23
2008,El Dorado County,718,495,264,231, , , ,718,495,264,231, , , ,406,206,200,89,58,31, , , ,64,23,15,16,10,35,27,2,5,1,124,96,28
2008,Fresno County,4072,3059,2286,773,277,256,21,4072,3059,2286,773,277,256,21,1091,899,192,1691,1131,560, , , ,286,134,58,76,18,127,76,18,23,10,600,448,152
2008,Glenn County,123,93,49,44, , , ,123,93,49,44, , , ,68,28,40,25,21,4, , , ,9,3,2,4,0, , , , , ,21,7,14
2008,Humboldt County,594,399,290,109,22,14,8,594,399,290,109,22,14,8,238,184,54,139,92,47, , , ,53,13,9,20,11,30,17,4,9,0,112,81,31
2008,Imperial County,692,512,348,164, , , ,692,512,348,164, , , ,270,180,90,242,168,74, , , ,55,22,10,20,3,24,14,4,6,0,101,53,48
2008,Inyo County,128,76,51,25, , , ,128,76,51,25, , , ,57,38,19,19,13,6, , , ,14,4,3,5,2, , , , , ,38,13,25
2008,Kern County,2866,1940,1423,517,14,10,4,2866,1940,1423,517,14,10,4,1209,908,301,717,505,212, , , ,198,86,51,52,9,101,64,14,21,2,627,287,340
2008,Kings County,538,367,187,180, , , ,538,367,187,180, , , ,228,83,145,139,104,35, , , ,51,19,13,16,3, , , , , ,120,47,73
2008,Lake County,284,199,90,109, , , ,284,199,90,109, , , ,156,58,98,43,32,11, , , ,34,16,8,8,2, , , , , ,51,23,28
2008,Lassen County,158,112,88,24, , , ,158,112,88,24, , , ,94,72,22,18,16,2, , , ,11,4,1,4,2,6,3,1,2,0,29,14,15
2008,Los Angeles County,46086,37068,24390,12678,325,200,125,46086,37068,24390,12678,325,200,125,16393,9513,6880,20350,14677,5673, , , ,2128,1015,298,486,329,1089,738,80,152,119,5801,2535,3266
2008,Madera County,376,218,156,62, , , ,376,218,156,62, , , ,114,79,35,104,77,27, , , ,38,16,10,10,2, , , , , ,120,51,69
2008,Marin County,908,676,479,197,8,7,1,908,676,479,197,8,7,1,321,210,111,347,262,85, , , ,84,34,9,30,11,48,28,5,12,3,100,48,52
2008,Mariposa County,94,69,55,14, , , ,94,69,55,14, , , ,69,55,14, , , , , , ,10,4,1,4,1, , , , , ,15,8,7
2008,Mendocino County,414,252,186,66, , , ,414,252,186,66, , , ,172,130,42,80,56,24, , , ,51,16,7,20,8,27,17,4,3,3,84,40,44
2008,Merced County,843,577,428,149,18,10,8,843,577,428,149,18,10,8,257,201,56,302,217,85, , , ,82,29,17,26,10,21,16,0,5,0,163,68,95
2008,Modoc County,50,36,29,7, , , ,50,36,29,7, , , ,29,23,6,7,6,1, , , ,8,2,1,2,3, , , , , ,6,4,2
2008,Mono County,87,70,49,21, , , ,87,70,49,21, , , ,44,27,17,26,22,4, , , ,9,4,2,3,0, , , , , ,8,6,2
2008,Monterey County,1509,1027,764,263,22,20,2,1509,1027,764,263,22,20,2,430,314,116,575,430,145, , , ,128,51,32,33,12,48,27,7,12,2,306,221,85
2008,Napa County,553,382,292,90,107,97,10,553,382,292,90,107,97,10,129,98,31,146,97,49, , , ,48,22,8,14,4,23,14,3,5,1,100,46,54
2008,Nevada County,365,265,134,131, , , ,365,265,134,131, , , ,185,69,116,80,65,15, , , ,27,12,2,12,1,13,9,0,4,0,60,20,40
2008,Orange County,10669,7904,4650,3254,68,50,18,10669,7904,4650,3254,68,50,18,3645,1854,1791,4191,2746,1445, , , ,796,277,204,135,180,419,219,79,62,59,1550,416,1134
2008,Placer County,1050,799,471,328, , , ,1050,799,471,328, , , ,434,231,203,365,240,125, , , ,108,42,11,50,5, , , , , ,143,109,34
2008,Plumas County,87,68,34,34, , , ,87,68,34,34, , , ,68,34,34, , , , , , ,10,3,3,3,1, , , , , ,9,5,4
2008,Riverside County,7792,5799,3314,2485,70,49,21,7792,5799,3314,2485,70,49,21,4109,2166,1943,1620,1099,521, , , ,805,255,138,271,141,316,164,45,53,54,872,294,578
2008,Sacramento County,17028,15487,10467,5020,842,764,78,5576,4035,2605,1430,67,47,20,2402,1510,892,1566,1048,518,10677,7145,3532,484,183,53,105,143,178,106,23,26,23,879,718,161
2008,San Benito County,134,103,89,14, , , ,134,103,89,14, , , ,69,59,10,34,30,4, , , ,12,6,1,4,1, , , , , ,19,14,5
2008,San Bernardino County,7666,5550,3167,2383,244,103,141,7666,5550,3167,2383,244,103,141,3399,1764,1635,1907,1300,607, , , ,551,240,60,165,86,258,134,40,70,14,1307,372,935
2008,San Diego County,11313,8545,5579,2966,323,222,101,11313,8545,5579,2966,323,222,101,3953,2328,1625,4269,3029,1240, , , ,982,321,176,255,230,332,205,46,65,16,1454,1112,342
2008,San Francisco County,4619,4020,3351,669,181,77,104,4619,4020,3351,669,181,77,104,1066,883,183,2773,2391,382, , , ,259,127,37,13,82,159,91,19,36,13,181,159,22
2008,San Joaquin County,2616,1954,1064,890,24,18,6,2616,1954,1064,890,24,18,6,869,354,515,1061,692,369, , , ,233,96,52,57,28,100,59,18,20,3,329,140,189
2008,San Luis Obispo County,1099,850,509,341,173,140,33,1099,850,509,341,173,140,33,382,157,225,295,212,83, , , ,92,34,15,20,23, , , , , ,157,105,52
2008,San Mateo County,2290,1731,1267,464, , , ,2290,1731,1267,464, , , ,601,435,166,1130,832,298, , , ,129,55,12,38,24, , , , , ,430,205,225
2008,Santa Barbara County,1760,1155,824,331,52,36,16,1760,1155,824,331,52,36,16,654,479,175,449,309,140, , , ,142,51,23,42,26,70,35,12,17,6,393,269,124
2008,Santa Clara County,5338,3780,2815,965,96,52,44,5338,3780,2815,965,96,52,44,683,522,161,3001,2241,760, , , ,493,170,87,131,105,202,108,27,35,32,863,304,559
2008,Santa Cruz County,879,656,359,297,47,21,26,879,656,359,297,47,21,26,341,138,203,268,200,68, , , ,91,35,13,26,17, , , , , ,132,98,34
2008,Shasta County,649,441,299,142, , , ,649,441,299,142, , , ,240,163,77,201,136,65, , , ,79,24,19,16,20, , , , , ,129,54,75
2008,Sierra County,22,15,11,4, , , ,22,15,11,4, , , ,15,11,4, , , , , , ,2,1,0,1,0, , , , , ,5,4,1
2008,Siskiyou County,259,182,133,49, , , ,259,182,133,49, , , ,121,91,30,61,42,19, , , ,28,8,5,7,8,8,5,0,3,0,41,16,25
2008,Solano County,1638,1120,566,554,6,4,2,1638,1120,566,554,6,4,2,477,115,362,637,447,190, , , ,144,65,18,51,10,84,53,9,21,1,290,225,65
2008,Sonoma County,1764,1304,919,385,41,24,17,1764,1304,919,385,41,24,17,706,507,199,557,388,169, , , ,130,53,18,33,26,52,31,9,11,1,278,99,179
2008,Stanislaus County,1733,1290,910,380,22,11,11,1733,1290,910,380,22,11,11,661,470,191,607,429,178, , , ,136,50,18,37,31,47,30,4,12,1,260,208,52
2008,Sutter County,305,238,170,68, , , ,305,238,170,68, , , ,134,102,32,104,68,36, , , ,27,11,9,6,1, , , , , ,40,33,7
2008,Tehama County,272,180,123,57, , , ,272,180,123,57, , , ,117,85,32,63,38,25, , , ,25,7,7,8,3, , , , , ,67,54,13
2008,Trinity County,70,36,17,19, , , ,70,36,17,19, , , ,36,17,19, , , , , , ,10,4,2,2,2, , , , , ,24,9,15
2008,Tulare County,1827,1191,866,325,6,5,1,1827,1191,866,325,6,5,1,686,499,187,499,362,137, , , ,213,72,65,51,25,83,43,11,14,15,340,130,210
2008,Tuolumne County,209,149,79,70, , , ,209,149,79,70, , , ,131,65,66,18,14,4, , , ,24,8,4,7,5,7,4,1,2,0,29,15,14
2008,Ventura County,2841,2069,1309,760,43,28,15,2841,2069,1309,760,43,28,15,1223,723,500,803,558,245, , , ,244,87,55,50,52,87,54,12,13,8,441,341,100
2008,Yolo County,923,639,334,305,77,43,34,923,639,334,305,77,43,34,256,84,172,306,207,99, , , ,102,36,34,18,14,35,24,4,7,0,147,44,103
2008,Yuba County,344,216,163,53, , , ,344,216,163,53, , , ,177,136,41,39,27,12, , , ,19,12,3,3,1, , , , , ,109,39,70
2009,Alameda County,5575,4599,3031,1568,214,133,81,5575,4599,3031,1568,214,133,81,1659,999,660,2726,1899,827, , , ,350,154,62,97,37, , , , , ,626,224,402
2009,Alpine County,19,14,11,3, , , ,19,14,11,3, , , ,14,11,3, , , , , , ,3,1,0,2,0, , , , , ,2,1,1
2009,Amador County,158,118,72,46, , , ,158,118,72,46, , , ,91,48,43,27,24,3, , , ,25,8,9,7,1, , , , , ,15,11,4
2009,Butte County,755,525,277,248,24,16,8,755,525,277,248,24,16,8,256,101,155,245,160,85, , , ,90,29,29,23,9, , , , , ,140,55,85
2009,Calaveras County,148,116,67,49, , , ,148,116,67,49, , , ,106,58,48,10,9,1, , , ,16,7,3,5,1, , , , , ,16,12,4
2009,Colusa County,112,86,51,35, , , ,112,86,51,35, , , ,64,32,32,22,19,3, , , ,9,2,2,3,2, , , , , ,17,10,7
2009,Contra Costa County,3207,2602,1831,771,296,208,88,2947,2342,1647,695,36,24,12,956,640,316,1350,983,367, , , ,156,86,22,39,9,109,69,10,19,11,340,155,185
2009,Del Norte County,121,77,43,34, , , ,121,77,43,34, , , ,63,30,33,14,13,1, , , ,10,4,2,3,1, , , , , ,34,10,24
2009,El Dorado County,688,467,241,226, , , ,688,467,241,226, , , ,379,184,195,88,57,31, , , ,69,24,17,25,3,31,26,1,4,0,121,94,27
2009,Fresno County,3853,2951,2215,736,280,255,25,3853,2951,2215,736,280,255,25,1044,831,213,1627,1129,498, , , ,252,115,50,72,15,104,69,9,18,8,546,414,132
2009,Glenn County,115,84,44,40, , , ,115,84,44,40, , , ,61,25,36,23,19,4, , , ,9,3,2,4,0, , , , , ,22,10,12
2009,Humboldt County,598,400,294,106,21,13,8,598,400,294,106,21,13,8,231,181,50,148,100,48, , , ,55,17,9,20,9,30,17,4,9,0,113,79,34
2009,Imperial County,680,502,345,157, , , ,680,502,345,157, , , ,270,182,88,232,163,69, , , ,54,21,10,20,3,24,14,4,6,0,100,54,46
2009,Inyo County,128,76,51,25, , , ,128,76,51,25, , , ,57,38,19,19,13,6, , , ,14,4,3,5,2, , , , , ,38,13,25
2009,Kern County,2724,1879,1377,502,15,11,4,2724,1879,1377,502,15,11,4,1140,856,284,724,510,214, , , ,192,85,50,45,12,92,59,13,18,2,561,277,284
2009,Kings County,531,363,183,180, , , ,531,363,183,180, , , ,221,80,141,142,103,39, , , ,48,18,12,15,3, , , , , ,120,50,70
2009,Lake County,283,203,94,109, , , ,283,203,94,109, , , ,158,59,99,45,35,10, , , ,36,17,8,10,1, , , , , ,44,32,12
2009,Lassen County,160,110,86,24, , , ,160,110,86,24, , , ,95,73,22,15,13,2, , , ,11,4,1,4,2,5,3,0,2,0,34,14,20
2009,Los Angeles County,47351,37302,24606,12696,316,201,115,47351,37302,24606,12696,316,201,115,16589,9567,7022,20397,14838,5559, , , ,2187,1051,297,532,307,1129,768,82,160,119,6733,4389,2344
2009,Madera County,375,215,152,63, , , ,375,215,152,63, , , ,110,74,36,105,78,27, , , ,35,16,9,8,2, , , , , ,125,55,70
2009,Marin County,875,658,465,193,7,6,1,875,658,465,193,7,6,1,312,202,110,339,257,82, , , ,82,34,7,32,9,43,26,4,10,3,92,42,50
2009,Mariposa County,96,70,56,14, , , ,96,70,56,14, , , ,70,56,14, , , , , , ,10,4,1,4,1, , , , , ,16,12,4
2009,Mendocino County,407,251,185,66, , , ,407,251,185,66, , , ,168,128,40,83,57,26, , , ,53,18,7,18,10,26,16,4,3,3,77,36,41
2009,Merced County,822,555,414,141,19,10,9,822,555,414,141,19,10,9,252,198,54,284,206,78, , , ,83,29,17,25,12,21,16,0,5,0,163,68,95
2009,Modoc County,43,32,28,4, , , ,43,32,28,4, , , ,25,22,3,7,6,1, , , ,6,2,1,1,2, , , , , ,5,4,1
2009,Mono County,89,72,46,26, , , ,89,72,46,26, , , ,49,26,23,23,20,3, , , ,9,4,2,3,0, , , , , ,8,6,2
2009,Monterey County,1488,998,745,253,23,21,2,1488,998,745,253,23,21,2,431,311,120,544,413,131, , , ,128,46,24,44,14,58,36,7,13,2,304,221,83
2009,Napa County,546,366,281,85,94,91,3,546,366,281,85,94,91,3,127,96,31,145,94,51, , , ,48,21,8,17,2,23,14,3,5,1,109,52,57
2009,Nevada County,360,260,132,128, , , ,360,260,132,128, , , ,187,72,115,73,60,13, , , ,23,10,2,10,1,13,9,0,4,0,64,22,42
2009,Orange County,10392,7789,4548,3241,67,52,15,10392,7789,4548,3241,67,52,15,3604,1807,1797,4118,2689,1429, , , ,717,271,135,170,141,403,212,75,58,58,1483,418,1065
2009,Placer County,1036,785,461,324, , , ,1036,785,461,324, , , ,433,233,200,352,228,124, , , ,108,42,11,50,5, , , , , ,143,119,24
2009,Plumas County,86,65,33,32, , , ,86,65,33,32, , , ,65,33,32, , , , , , ,11,3,3,3,2, , , , , ,10,6,4
2009,Riverside County,7486,5486,3158,2328,65,45,20,7486,5486,3158,2328,65,45,20,3857,2049,1808,1564,1064,500, , , ,822,267,135,275,145,327,162,53,55,57,851,309,542
2009,Sacramento County,16927,15489,10553,4936,828,760,68,4980,3542,2307,1235,63,46,17,1973,1229,744,1506,1032,474,11182,7532,3650,437,179,40,88,130,156,106,25,19,6,845,679,166
2009,San Benito County,134,101,82,19, , , ,134,101,82,19, , , ,64,55,9,37,27,10, , , ,13,6,3,3,1, , , , , ,20,15,5
2009,San Bernardino County,7538,5489,3151,2338,246,106,140,7538,5489,3151,2338,246,106,140,3389,1790,1599,1854,1255,599, , , ,524,233,57,148,86,260,130,38,62,30,1265,385,880
2009,San Diego County,10951,8178,5388,2790,314,214,100,10951,8178,5388,2790,314,214,100,3757,2261,1496,4107,2913,1194, , , ,995,331,174,253,237,324,202,45,60,17,1454,1112,342
2009,San Francisco County,4899,4140,3373,767,185,81,104,4899,4140,3373,767,185,81,104,1102,925,177,2853,2367,486, , , ,252,130,34,12,76,150,87,18,32,13,357,167,190
2009,San Joaquin County,2436,1798,988,810,26,19,7,2436,1798,988,810,26,19,7,782,320,462,990,649,341, , , ,232,96,50,61,25,97,58,16,19,4,309,136,173
2009,San Luis Obispo County,1081,835,498,337,177,142,35,1081,835,498,337,177,142,35,372,153,219,286,203,83, , , ,90,33,14,24,19, , , , , ,156,106,50
2009,San Mateo County,2248,1701,1123,578, , , ,2248,1701,1123,578, , , ,585,304,281,1116,819,297, , , ,129,57,12,39,21, , , , , ,418,182,236
2009,Santa Barbara County,1695,1118,794,324,50,34,16,1695,1118,794,324,50,34,16,634,457,177,434,303,131, , , ,142,50,23,41,28,67,33,9,20,5,368,242,126
2009,Santa Clara County,5289,3731,2757,974,95,52,43,5289,3731,2757,974,95,52,43,672,504,168,2964,2201,763, , , ,469,170,81,120,98,200,108,27,31,34,889,299,590
2009,Santa Cruz County,856,638,361,277,44,18,26,856,638,361,277,44,18,26,337,145,192,257,198,59, , , ,93,32,13,25,23, , , , , ,125,94,31
2009,Shasta County,593,396,271,125, , , ,593,396,271,125, , , ,219,142,77,177,129,48, , , ,68,23,14,17,14, , , , , ,129,54,75
2009,Sierra County,22,14,10,4, , , ,22,14,10,4, , , ,14,10,4, , , , , , ,3,1,0,1,1, , , , , ,5,4,1
2009,Siskiyou County,239,169,126,43, , , ,239,169,126,43, , , ,107,82,25,62,44,18, , , ,24,8,4,7,5,7,4,0,3,0,39,15,24
2009,Solano County,1546,1079,550,529,6,4,2,1546,1079,550,529,6,4,2,450,112,338,623,434,189, , , ,126,53,24,38,11,83,51,9,22,1,258,204,54
2009,Sonoma County,1690,1253,879,374,42,23,19,1690,1253,879,374,42,23,19,698,490,208,513,366,147, , , ,112,53,17,34,8,54,32,9,12,1,271,114,157
2009,Stanislaus County,1652,1222,868,354,21,11,10,1652,1222,868,354,21,11,10,621,445,176,580,412,168, , , ,130,47,17,37,29,45,29,3,12,1,255,205,50
2009,Sutter County,299,225,172,53, , , ,299,225,172,53, , , ,133,107,26,92,65,27, , , ,32,11,10,9,2, , , , , ,42,35,7
2009,Tehama County,244,173,116,57, , , ,244,173,116,57, , , ,114,79,35,59,37,22, , , ,25,8,7,7,3, , , , , ,46,36,10
2009,Trinity County,60,32,16,16, , , ,60,32,16,16, , , ,32,16,16, , , , , , ,7,3,1,2,1, , , , , ,21,8,13
2009,Tulare County,1801,1171,854,317,5,4,1,1801,1171,854,317,5,4,1,669,485,184,497,365,132, , , ,196,69,38,45,44,83,43,11,14,15,351,128,223
2009,Tuolumne County,199,143,76,67, , , ,199,143,76,67, , , ,126,63,63,17,13,4, , , ,20,7,3,6,4,7,4,1,2,0,29,17,12
2009,Ventura County,2785,2029,1298,731,41,28,13,2785,2029,1298,731,41,28,13,1193,731,462,795,539,256, , , ,245,90,53,51,51,87,54,12,13,8,424,333,91
2009,Yolo County,864,627,338,289,78,46,32,864,627,338,289,78,46,32,248,84,164,301,208,93, , , ,94,35,28,18,13,33,22,4,7,0,110,42,68
2009,Yuba County,349,215,164,51, , , ,349,215,164,51, , , ,177,137,40,38,27,11, , , ,20,12,3,4,1, , , , , ,114,35,79
2010,Alameda County,5510,4425,2887,1538,214,136,78,5510,4425,2887,1538,214,136,78,1635,986,649,2576,1765,811, , , ,343,150,57,102,34,161,100,17,44,0,581,195,386
2010,Alpine County,22,18,15,3, , , ,22,18,15,3, , , ,18,15,3, , , , , , ,3,1,0,2,0, , , , , ,1,1,0
2010,Amador County,150,111,66,45, , , ,150,111,66,45, , , ,89,46,43,22,20,2, , , ,24,8,7,8,1, , , , , ,15,11,4
2010,Butte County,744,521,276,245,24,16,8,744,521,276,245,24,16,8,258,101,157,239,159,80, , , ,84,27,19,24,14, , , , , ,139,57,82
2010,Calaveras County,128,102,58,44, , , ,128,102,58,44, , , ,95,52,43,7,6,1, , , ,14,6,2,5,1, , , , , ,12,10,2
2010,Colusa County,119,92,55,37, , , ,119,92,55,37, , , ,69,36,33,23,19,4, , , ,10,3,2,3,2, , , , , ,17,10,7
2010,Contra Costa County,3153,2579,1825,754,299,213,86,2887,2313,1635,678,33,23,10,952,637,315,1328,975,353, , , ,156,86,22,39,9,102,63,11,15,13,316,120,196
2010,Del Norte County,129,78,44,34, , , ,129,78,44,34, , , ,63,30,33,15,14,1, , , ,10,4,3,3,0, , , , , ,41,9,32
2010,El Dorado County,612,431,230,201, , , ,612,431,230,201, , , ,346,173,173,85,57,28, , , ,50,21,12,14,3,18,13,1,4,0,113,89,24
2010,Fresno County,3448,2597,2051,546,282,258,24,3448,2597,2051,546,282,258,24,891,693,198,1424,1100,324, , , ,216,95,44,67,10,90,56,9,17,8,545,410,135
2010,Glenn County,118,91,46,45, , , ,118,91,46,45, , , ,68,26,42,23,20,3, , , ,4,2,0,2,0, , , , , ,23,9,14
2010,Humboldt County,564,398,293,105,20,12,8,564,398,293,105,20,12,8,227,177,50,151,104,47, , , ,52,15,7,20,10,28,17,3,8,0,86,40,46
2010,Imperial County,658,485,335,150, , , ,658,485,335,150, , , ,271,180,91,214,155,59, , , ,59,21,12,20,6,24,14,4,6,0,90,50,40
2010,Inyo County,117,71,46,25, , , ,117,71,46,25, , , ,53,34,19,18,12,6, , , ,14,4,3,5,2, , , , , ,32,10,22
2010,Kern County,2644,1849,1364,485,15,11,4,2644,1849,1364,485,15,11,4,1091,822,269,743,531,212, , , ,186,85,43,51,7,84,53,11,18,2,525,243,282
2010,Kings County,520,353,173,180, , , ,520,353,173,180, , , ,214,76,138,139,97,42, , , ,48,18,12,15,3, , , , , ,119,93,26
2010,Lake County,279,193,87,106, , , ,279,193,87,106, , , ,153,58,95,40,29,11, , , ,35,16,8,10,1, , , , , ,51,39,12
2010,Lassen County,161,112,88,24, , , ,161,112,88,24, , , ,94,72,22,18,16,2, , , ,11,4,1,4,2,5,3,0,2,0,33,13,20
2010,Los Angeles County,46034,36940,24176,12764,315,191,124,46034,36940,24176,12764,315,191,124,16990,9501,7489,19635,14484,5151, , , ,2134,1014,286,509,325,1110,750,79,167,114,5850,3718,2132
2010,Madera County,335,204,147,57, , , ,335,204,147,57, , , ,104,71,33,100,76,24, , , ,32,15,7,9,1, , , , , ,99,39,60
2010,Marin County,844,625,449,176,7,6,1,844,625,449,176,7,6,1,296,193,103,322,250,72, , , ,85,35,8,29,13,40,24,4,9,3,94,55,39
2010,Mariposa County,95,69,56,13, , , ,95,69,56,13, , , ,69,56,13, , , , , , ,10,4,1,4,1, , , , , ,16,10,6
2010,Mendocino County,384,236,173,63, , , ,384,236,173,63, , , ,156,118,38,80,55,25, , , ,52,18,6,18,10,26,16,3,4,3,70,31,39
2010,Merced County,804,550,325,225,19,10,9,804,550,325,225,19,10,9,250,113,137,281,202,79, , , ,78,28,17,20,13,20,15,0,5,0,156,62,94
2010,Modoc County,45,34,25,9, , , ,45,34,25,9, , , ,26,18,8,8,7,1, , , ,6,2,1,1,2, , , , , ,5,4,1
2010,Mono County,89,72,46,26, , , ,89,72,46,26, , , ,51,28,23,21,18,3, , , ,9,4,2,3,0, , , , , ,8,6,2
2010,Monterey County,1407,944,719,225,21,19,2,1407,944,719,225,21,19,2,412,307,105,511,393,118, , , ,128,46,24,44,14,55,36,7,9,3,280,209,71
2010,Napa County,546,366,284,82,100,97,3,546,366,284,82,100,97,3,129,99,30,137,88,49, , , ,52,22,10,14,6,21,14,1,5,1,107,51,56
2010,Nevada County,356,259,133,126, , , ,356,259,133,126, , , ,185,72,113,74,61,13, , , ,23,11,2,9,1,12,8,0,4,0,62,22,40
2010,Orange County,9886,7516,4748,2768,75,54,21,9886,7516,4748,2768,75,54,21,3511,2074,1437,3930,2620,1310, , , ,696,253,165,129,149,382,197,71,57,57,1292,407,885
2010,Placer County,973,725,437,288, , , ,973,725,437,288, , , ,403,214,189,322,223,99, , , ,105,41,11,48,5, , , , , ,143,119,24
2010,Plumas County,85,63,31,32, , , ,85,63,31,32, , , ,63,31,32, , , , , , ,11,3,3,3,2, , , , , ,11,7,4
2010,Riverside County,7214,5347,3164,2183,66,46,20,7214,5347,3164,2183,66,46,20,3805,2086,1719,1476,1032,444, , , ,786,262,123,262,139,288,142,45,49,52,793,281,512
2010,Sacramento County,16655,15394,10663,4731,901,801,100,4725,3464,2249,1215,72,47,25,1897,1186,711,1495,1016,479,11101,7660,3441,394,167,38,73,116,153,104,24,19,6,714,564,150
2010,San Benito County,134,101,83,18, , , ,134,101,83,18, , , ,68,58,10,33,25,8, , , ,13,6,2,4,1, , , , , ,20,15,5
2010,San Bernardino County,7387,5387,3114,2273,243,104,139,7387,5387,3114,2273,243,104,139,3310,1767,1543,1834,1243,591, , , ,503,224,54,143,82,236,122,38,51,25,1261,383,878
2010,San Diego County,10488,7930,5295,2635,302,208,94,10488,7930,5295,2635,302,208,94,3675,2201,1474,3953,2886,1067, , , ,952,312,169,240,231,385,238,52,67,28,1221,966,255
2010,San Francisco County,4600,3872,3228,644,178,82,96,4600,3872,3228,644,178,82,96,1065,896,169,2629,2250,379, , , ,255,132,35,11,77,157,89,18,25,25,316,138,178
2010,San Joaquin County,2210,1625,902,723,24,19,5,2210,1625,902,723,24,19,5,699,292,407,902,591,311, , , ,214,82,46,57,29,71,39,13,17,2,300,129,171
2010,San Luis Obispo County,1030,800,477,323,165,133,32,1030,800,477,323,165,133,32,358,147,211,277,197,80, , , ,90,33,14,24,19, , , , , ,140,98,42
2010,San Mateo County,2204,1663,1104,559, , , ,2204,1663,1104,559, , , ,603,320,283,1060,784,276, , , ,125,56,12,37,20, , , , , ,416,171,245
2010,Santa Barbara County,1625,1077,767,310,51,34,17,1625,1077,767,310,51,34,17,605,436,169,421,297,124, , , ,133,48,21,45,19,68,36,10,17,5,347,237,110
2010,Santa Clara County,5205,3619,2665,954,105,49,56,5205,3619,2665,954,105,49,56,690,537,153,2824,2079,745, , , ,498,172,89,125,112,225,118,29,42,36,863,292,571
2010,Santa Cruz County,808,605,343,262,44,19,25,808,605,343,262,44,19,25,313,131,182,248,193,55, , , ,92,32,13,27,20, , , , , ,111,87,24
2010,Shasta County,565,401,285,116,27,23,4,565,401,285,116,27,23,4,210,141,69,164,121,43, , , ,72,25,14,20,13, , , , , ,92,44,48
2010,Sierra County,20,15,10,5, , , ,20,15,10,5, , , ,15,10,5, , , , , , ,2,1,0,1,0, , , , , ,3,3,0
2010,Siskiyou County,216,156,117,39, , , ,216,156,117,39, , , ,99,76,23,57,41,16, , , ,20,8,3,5,4,7,3,0,3,1,33,14,19
2010,Solano County,1397,984,510,474,6,4,2,1397,984,510,474,6,4,2,394,107,287,584,399,185, , , ,122,49,19,34,20,74,45,9,18,2,217,168,49
2010,Sonoma County,1628,1201,842,359,48,24,24,1628,1201,842,359,48,24,24,655,469,186,498,349,149, , , ,107,50,17,38,2,53,32,9,11,1,267,98,169
2010,Stanislaus County,1512,1133,812,321,24,11,13,1512,1133,812,321,24,11,13,557,402,155,552,399,153, , , ,120,43,14,34,29,40,28,1,9,2,219,171,48
2010,Sutter County,301,226,172,54, , , ,301,226,172,54, , , ,137,108,29,89,64,25, , , ,32,11,10,9,2, , , , , ,43,36,7
2010,Tehama County,242,169,117,52, , , ,242,169,117,52, , , ,112,80,32,57,37,20, , , ,24,8,7,7,2, , , , , ,49,39,10
2010,Trinity County,59,31,15,16, , , ,59,31,15,16, , , ,31,15,16, , , , , , ,8,3,1,3,1, , , , , ,20,7,13
2010,Tulare County,1777,1165,849,316,6,5,1,1777,1165,849,316,6,5,1,662,481,181,497,363,134, , , ,189,65,55,42,27,72,42,6,13,11,351,249,102
2010,Tuolumne County,199,145,77,68, , , ,199,145,77,68, , , ,128,65,63,17,12,5, , , ,20,7,3,6,4,7,4,1,2,0,27,15,12
2010,Ventura County,2778,2028,1295,733,40,29,11,2778,2028,1295,733,40,29,11,1205,739,466,783,527,256, , , ,235,89,50,50,46,87,54,12,13,8,428,331,97
2010,Yolo County,840,593,327,266,78,46,32,840,593,327,266,78,46,32,236,83,153,279,198,81, , , ,89,32,27,18,12,30,21,4,5,0,128,43,85
2010,Yuba County,326,205,157,48, , , ,326,205,157,48, , , ,168,130,38,37,27,10, , , ,17,11,2,4,0, , , , , ,104,35,69
2011,Alameda County,5398,4328,2793,1535,211,132,79,5398,4328,2793,1535,211,132,79,1599,950,649,2518,1711,807, , , ,351,148,60,112,31,161,100,18,43,0,558,188,370
2011,Alpine County,21,18,15,3, , , ,21,18,15,3, , , ,18,15,3, , , , , , ,3,1,0,2,0, , , , , ,0,0,0
2011,Amador County,156,117,69,48, , , ,156,117,69,48, , , ,95,49,46,22,20,2, , , ,24,8,7,7,2, , , , , ,15,11,4
2011,Butte County,784,554,281,273,28,16,12,784,554,281,273,28,16,12,282,108,174,244,157,87, , , ,84,25,19,28,12, , , , , ,146,60,86
2011,Calaveras County,124,99,57,42, , , ,124,99,57,42, , , ,92,51,41,7,6,1, , , ,12,6,1,4,1, , , , , ,13,10,3
2011,Colusa County,115,88,53,35, , , ,115,88,53,35, , , ,65,34,31,23,19,4, , , ,10,3,3,3,1, , , , , ,17,10,7
2011,Contra Costa County,3023,2503,1785,718,298,214,84,2757,2237,1593,644,32,22,10,920,618,302,1285,953,332, , , ,137,77,17,32,11,94,55,10,15,14,289,112,177
2011,Del Norte County,121,68,39,29, , , ,121,68,39,29, , , ,55,27,28,13,12,1, , , ,10,3,3,4,0, , , , , ,43,11,32
2011,El Dorado County,597,415,215,200, , , ,597,415,215,200, , , ,333,159,174,82,56,26, , , ,53,19,13,19,2,19,13,1,4,1,110,86,24
2011,Fresno County,3362,2583,2032,551,280,247,33,3362,2583,2032,551,280,247,33,942,734,208,1361,1051,310, , , ,216,103,47,56,10,82,48,9,17,8,481,357,124
2011,Glenn County,102,74,37,37, , , ,102,74,37,37, , , ,52,18,34,22,19,3, , , ,6,3,0,3,0, , , , , ,22,9,13
2011,Humboldt County,548,379,277,102,18,11,7,548,379,277,102,18,11,7,212,166,46,149,100,49, , , ,48,12,8,24,4,25,14,3,7,1,96,42,54
2011,Imperial County,639,466,321,145, , , ,639,466,321,145, , , ,265,177,88,201,144,57, , , ,57,19,12,19,7,24,14,4,6,0,92,47,45
2011,Inyo County,114,70,46,24, , , ,114,70,46,24, , , ,53,34,19,17,12,5, , , ,13,4,3,4,2, , , , , ,31,11,20
2011,Kern County,2689,1903,1378,525,15,11,4,2689,1903,1378,525,15,11,4,1118,838,280,770,529,241, , , ,181,86,38,45,12,84,52,12,18,2,521,236,285
2011,Kings County,523,366,184,182, , , ,523,366,184,182, , , ,206,69,137,160,115,45, , , ,48,17,11,15,5, , , , , ,109,48,61
2011,Lake County,253,178,80,98, , , ,253,178,80,98, , , ,139,51,88,39,29,10, , , ,33,15,7,10,1, , , , , ,42,33,9
2011,Lassen County,128,79,61,18, , , ,128,79,61,18, , , ,62,45,17,17,16,1, , , ,11,4,1,4,2,5,3,0,2,0,33,13,20
2011,Los Angeles County,45190,36452,23727,12725,310,187,123,45190,36452,23727,12725,310,187,123,16768,9197,7571,19374,14343,5031, , , ,2039,969,268,516,286,1081,730,80,153,118,5618,4258,1360
2011,Madera County,326,202,142,60, , , ,326,202,142,60, , , ,99,69,30,103,73,30, , , ,34,17,7,9,1, , , , , ,90,38,52
2011,Marin County,817,601,435,166,9,8,1,817,601,435,166,9,8,1,282,183,99,310,244,66, , , ,86,32,8,34,12,38,22,4,9,3,92,55,37
2011,Mariposa County,97,69,55,14, , , ,97,69,55,14, , , ,69,55,14, , , , , , ,10,4,1,4,1, , , , , ,18,14,4
2011,Mendocino County,360,215,164,51, , , ,360,215,164,51, , , ,138,111,27,77,53,24, , , ,52,18,6,18,10,26,16,3,4,3,67,31,36
2011,Merced County,760,516,313,203,20,11,9,760,516,313,203,20,11,9,237,116,121,259,186,73, , , ,71,23,17,18,13,20,15,0,5,0,153,62,91
2011,Modoc County,38,29,21,8, , , ,38,29,21,8, , , ,23,16,7,6,5,1, , , ,4,1,0,1,2, , , , , ,5,4,1
2011,Mono County,86,70,46,24, , , ,86,70,46,24, , , ,49,28,21,21,18,3, , , ,8,4,2,2,0, , , , , ,8,6,2
2011,Monterey County,1349,883,667,216,25,19,6,1349,883,667,216,25,19,6,381,283,98,477,365,112, , , ,125,46,26,42,11,55,36,7,9,3,286,204,82
2011,Napa County,559,378,295,83,110,101,9,559,378,295,83,110,101,9,130,103,27,138,91,47, , , ,53,20,9,17,7,23,14,3,5,1,105,83,22
2011,Nevada County,337,245,126,119, , , ,337,245,126,119, , , ,173,66,107,72,60,12, , , ,23,10,3,9,1,12,8,0,4,0,57,20,37
2011,Orange County,9700,7369,4542,2827,80,55,25,9700,7369,4542,2827,80,55,25,3459,1948,1511,3830,2539,1291, , , ,705,235,156,115,199,368,190,69,56,53,1258,888,370
2011,Placer County,962,718,426,292, , , ,962,718,426,292, , , ,405,216,189,313,210,103, , , ,101,42,11,37,11, , , , , ,143,119,24
2011,Plumas County,83,61,31,30, , , ,83,61,31,30, , , ,61,31,30, , , , , , ,8,3,2,1,2, , , , , ,14,8,6
2011,Riverside County,6963,5237,3080,2157,61,44,17,6963,5237,3080,2157,61,44,17,3729,2021,1708,1447,1015,432, , , ,739,253,121,239,126,241,129,39,40,33,746,261,485
2011,Sacramento County,15669,14541,10298,4243,776,684,92,4510,3382,2243,1139,72,46,26,1879,1193,686,1431,1004,427,10455,7417,3038,393,165,39,71,118,135,90,22,18,5,600,477,123
2011,San Benito County,122,90,51,39, , , ,122,90,51,39, , , ,58,27,31,32,24,8, , , ,12,5,2,5,0, , , , , ,20,13,7
2011,San Bernardino County,6831,4998,2994,2004,225,103,122,6831,4998,2994,2004,225,103,122,3029,1706,1323,1744,1185,559, , , ,466,208,65,140,53,228,118,37,51,22,1139,375,764
2011,San Diego County,10311,7845,5219,2626,296,196,100,10311,7845,5219,2626,296,196,100,3692,2196,1496,3857,2827,1030, , , ,911,300,159,222,230,336,208,47,58,23,1219,968,251
2011,San Francisco County,4603,3866,3169,697,173,86,87,4603,3866,3169,697,173,86,87,1043,873,170,2650,2210,440, , , ,251,132,34,10,75,152,87,17,23,25,334,166,168
2011,San Joaquin County,2095,1562,866,696,23,17,6,2095,1562,866,696,23,17,6,691,284,407,848,565,283, , , ,185,75,32,49,29,71,39,13,17,2,277,122,155
2011,San Luis Obispo County,1027,799,476,323,166,134,32,1027,799,476,323,166,134,32,359,150,209,274,192,82, , , ,91,34,14,24,19, , , , , ,137,98,39
2011,San Mateo County,2091,1578,1053,525, , , ,2091,1578,1053,525, , , ,601,322,279,977,731,246, , , ,118,53,12,37,16, , , , , ,395,165,230
2011,Santa Barbara County,1590,1084,759,325,49,33,16,1590,1084,759,325,49,33,16,600,430,170,435,296,139, , , ,133,48,21,44,20,64,37,8,17,2,309,223,86
2011,Santa Clara County,5832,4284,3134,1150,108,48,60,5832,4284,3134,1150,108,48,60,1563,1189,374,2613,1897,716, , , ,489,171,85,128,105,217,115,29,39,34,842,304,538
2011,Santa Cruz County,781,596,346,250,38,17,21,781,596,346,250,38,17,21,313,138,175,245,191,54, , , ,81,32,13,23,13, , , , , ,104,81,23
2011,Shasta County,541,386,266,120,25,21,4,541,386,266,120,25,21,4,205,131,74,156,114,42, , , ,59,21,13,11,14, , , , , ,96,38,58
2011,Sierra County,21,16,11,5, , , ,21,16,11,5, , , ,16,11,5, , , , , , ,2,1,0,1,0, , , , , ,3,3,0
2011,Siskiyou County,207,155,117,38, , , ,207,155,117,38, , , ,100,77,23,55,40,15, , , ,13,7,2,3,1,7,4,0,3,0,32,13,19
2011,Solano County,1319,983,495,488,5,3,2,1319,983,495,488,5,3,2,415,107,308,563,385,178, , , ,102,46,16,28,12,65,42,8,13,2,169,137,32
2011,Sonoma County,1559,1130,804,326,47,25,22,1559,1130,804,326,47,25,22,610,444,166,473,335,138, , , ,112,48,13,33,18,47,27,8,11,1,270,223,47
2011,Stanislaus County,1413,1056,773,283,20,11,9,1413,1056,773,283,20,11,9,509,385,124,527,377,150, , , ,108,38,13,33,24,38,26,1,9,2,211,167,44
2011,Sutter County,283,214,161,53, , , ,283,214,161,53, , , ,127,99,28,87,62,25, , , ,26,9,9,8,0, , , , , ,43,36,7
2011,Tehama County,240,159,107,52, , , ,240,159,107,52, , , ,106,72,34,53,35,18, , , ,24,7,7,8,2, , , , , ,57,49,8
2011,Trinity County,64,34,19,15, , , ,64,34,19,15, , , ,34,19,15, , , , , , ,9,4,1,3,1, , , , , ,21,8,13
2011,Tulare County,1751,1149,845,304,5,4,1,1751,1149,845,304,5,4,1,653,484,169,491,357,134, , , ,180,59,56,43,22,71,41,6,13,11,351,252,99
2011,Tuolumne County,198,143,74,69, , , ,198,143,74,69, , , ,128,64,64,15,10,5, , , ,19,7,2,6,4,7,4,1,2,0,29,18,11
2011,Ventura County,2754,2006,1271,735,38,26,12,2754,2006,1271,735,38,26,12,1194,727,467,774,518,256, , , ,239,92,50,49,48,87,54,12,13,8,422,318,104
2011,Yolo County,822,581,321,260,70,47,23,822,581,321,260,70,47,23,242,81,161,269,193,76, , , ,86,32,23,19,12,31,22,4,5,0,124,43,81
2011,Yuba County,324,206,160,46, , , ,324,206,160,46, , , ,168,133,35,38,27,11, , , ,15,9,2,4,0, , , , , ,103,34,69
2012,Alameda County,5334,4285,2777,1508,220,137,83,5334,4285,2777,1508,220,137,83,1599,952,647,2466,1688,778, , , ,341,149,58,98,36,162,100,18,35,9,546,190,356
2012,Alpine County,19,17,14,3, , , ,19,17,14,3, , , ,17,14,3, , , , , , ,2,1,0,0,1, , , , , ,0,0,0
2012,Amador County,147,105,60,45, , , ,147,105,60,45, , , ,85,41,44,20,19,1, , , ,23,7,7,7,2, , , , , ,19,14,5
2012,Butte County,807,558,271,287,26,15,11,807,558,271,287,26,15,11,297,106,191,235,150,85, , , ,95,28,23,34,10, , , , , ,154,67,87
2012,Calaveras County,125,98,56,42, , , ,125,98,56,42, , , ,91,50,41,7,6,1, , , ,14,7,1,5,1, , , , , ,13,9,4
2012,Colusa County,116,86,49,37, , , ,116,86,49,37, , , ,63,30,33,23,19,4, , , ,11,3,2,3,3, , , , , ,19,11,8
2012,Contra Costa County,3002,2480,1766,714,301,210,91,2733,2211,1578,633,32,22,10,940,640,300,1239,916,323, , , ,125,68,9,28,20,103,62,10,16,15,294,110,184
2012,Del Norte County,121,69,37,32, , , ,121,69,37,32, , , ,57,26,31,12,11,1, , , ,11,5,2,4,0, , , , , ,41,33,8
2012,El Dorado County,618,422,206,216, , , ,618,422,206,216, , , ,341,153,188,81,53,28, , , ,56,21,13,19,3,17,12,1,4,0,123,97,26
2012,Fresno County,3385,2589,2068,521,293,263,30,3385,2589,2068,521,293,263,30,966,779,187,1330,1026,304, , , ,197,100,38,51,8,87,54,9,17,7,512,382,130
2012,Glenn County,108,79,40,39, , , ,108,79,40,39, , , ,60,24,36,19,16,3, , , ,5,2,0,3,0, , , , , ,24,13,11
2012,Humboldt County,545,374,279,95,19,11,8,545,374,279,95,19,11,8,210,168,42,145,100,45, , , ,47,12,10,12,13,26,14,3,7,2,98,73,25
2012,Imperial County,642,471,329,142, , , ,642,471,329,142, , , ,270,183,87,201,146,55, , , ,57,20,12,18,7,24,14,4,6,0,90,45,45
2012,Inyo County,114,70,46,24, , , ,114,70,46,24, , , ,53,34,19,17,12,5, , , ,13,4,3,4,2, , , , , ,31,22,9
2012,Kern County,2716,1891,1403,488,15,11,4,2716,1891,1403,488,15,11,4,1163,884,279,713,508,205, , , ,182,84,49,40,9,83,58,6,17,2,560,448,112
2012,Kings County,549,386,186,200, , , ,549,386,186,200, , , ,227,74,153,159,112,47, , , ,47,16,12,15,4, , , , , ,116,93,23
2012,Lake County,252,177,78,99, , , ,252,177,78,99, , , ,138,48,90,39,30,9, , , ,29,13,6,9,1, , , , , ,46,37,9
2012,Lassen County,136,85,66,19, , , ,136,85,66,19, , , ,69,51,18,16,15,1, , , ,11,4,1,4,2,5,3,0,2,0,35,14,21
2012,Los Angeles County,45146,36570,23838,12732,311,188,123,45146,36570,23838,12732,311,188,123,16796,9274,7522,19463,14376,5087, , , ,2022,983,272,481,286,1077,730,84,141,122,5477,4165,1312
2012,Madera County,325,200,143,57, , , ,325,200,143,57, , , ,104,72,32,96,71,25, , , ,32,15,6,8,3, , , , , ,93,39,54
2012,Marin County,835,613,439,174,9,8,1,835,613,439,174,9,8,1,297,192,105,307,239,68, , , ,75,28,8,28,11,38,22,4,9,3,109,71,38
2012,Mariposa County,97,69,56,13, , , ,97,69,56,13, , , ,69,56,13, , , , , , ,10,4,1,4,1, , , , , ,18,14,4
2012,Mendocino County,379,232,173,59, , , ,379,232,173,59, , , ,155,120,35,77,53,24, , , ,51,18,6,18,9,24,14,3,4,3,72,55,17
2012,Merced County,716,490,296,194,23,12,11,716,490,296,194,23,12,11,218,102,116,249,182,67, , , ,67,23,13,24,7,15,12,0,3,0,144,118,26
2012,Modoc County,44,31,18,13, , , ,44,31,18,13, , , ,25,13,12,6,5,1, , , ,8,3,1,1,3, , , , , ,5,4,1
2012,Mono County,86,70,44,26, , , ,86,70,44,26, , , ,50,27,23,20,17,3, , , ,8,4,2,2,0, , , , , ,8,6,2
2012,Monterey County,1345,891,672,219,27,21,6,1345,891,672,219,27,21,6,392,291,101,472,360,112, , , ,125,46,25,42,12,52,33,7,9,3,277,206,71
2012,Napa County,578,385,301,84,124,114,10,578,385,301,84,124,114,10,126,99,27,135,88,47, , , ,54,23,9,17,5,23,14,3,5,1,116,92,24
2012,Nevada County,322,227,116,111, , , ,322,227,116,111, , , ,163,64,99,64,52,12, , , ,24,10,3,10,1,12,8,0,4,0,59,44,15
2012,Orange County,9796,7434,4406,3028,79,55,24,9796,7434,4406,3028,79,55,24,3644,1885,1759,3711,2466,1245, , , ,743,277,181,119,166,368,194,74,56,44,1251,881,370
2012,Placer County,975,734,436,298, , , ,975,734,436,298, , , ,423,229,194,311,207,104, , , ,98,41,11,36,10, , , , , ,143,116,27
2012,Plumas County,76,54,29,25, , , ,76,54,29,25, , , ,54,29,25, , , , , , ,9,3,2,3,1, , , , , ,13,7,6
2012,Riverside County,6920,5178,2947,2231,73,53,20,6920,5178,2947,2231,73,53,20,3706,1916,1790,1399,978,421, , , ,717,250,113,231,123,234,132,32,42,28,791,327,464
2012,Sacramento County,16015,14875,10242,4633,784,693,91,4413,3273,2177,1096,67,46,21,1868,1186,682,1338,945,393,10885,7418,3467,390,167,39,67,117,146,97,24,19,6,604,487,117
2012,San Benito County,102,74,43,31, , , ,102,74,43,31, , , ,44,21,23,30,22,8, , , ,10,4,2,4,0, , , , , ,18,15,3
2012,San Bernardino County,7016,5112,2969,2143,229,101,128,7016,5112,2969,2143,229,101,128,3186,1718,1468,1697,1150,547, , , ,476,206,49,140,81,210,117,31,49,13,1218,902,316
2012,San Diego County,10432,7971,5303,2668,289,194,95,10432,7971,5303,2668,289,194,95,3816,2270,1546,3866,2839,1027, , , ,887,300,150,218,219,349,217,45,63,24,1225,973,252
2012,San Francisco County,4534,3794,3118,676,178,85,93,4534,3794,3118,676,178,85,93,1017,860,157,2599,2173,426, , , ,254,131,35,10,78,150,86,17,22,25,336,150,186
2012,San Joaquin County,2110,1570,874,696,27,22,5,2110,1570,874,696,27,22,5,682,280,402,861,572,289, , , ,173,73,26,48,26,64,38,12,10,4,303,240,63
2012,San Luis Obispo County,1034,804,461,343,167,128,39,1034,804,461,343,167,128,39,378,152,226,259,181,78, , , ,91,34,14,24,19, , , , , ,139,100,39
2012,San Mateo County,2060,1554,1027,527, , , ,2060,1554,1027,527, , , ,601,314,287,953,713,240, , , ,118,53,12,39,14, , , , , ,388,304,84
2012,Santa Barbara County,1602,1053,733,320,51,35,16,1602,1053,733,320,51,35,16,581,413,168,421,285,136, , , ,120,48,17,40,15,64,36,10,15,3,365,267,98
2012,Santa Clara County,5774,4205,3070,1135,108,49,59,5774,4205,3070,1135,108,49,59,1517,1131,386,2580,1890,690, , , ,459,168,59,118,114,245,126,30,47,42,865,337,528
2012,Santa Cruz County,753,559,335,224,26,15,11,753,559,335,224,26,15,11,286,124,162,247,196,51, , , ,82,32,13,23,14, , , , , ,112,88,24
2012,Shasta County,565,384,266,118,23,19,4,565,384,266,118,23,19,4,209,133,76,152,114,38, , , ,64,23,13,12,16, , , , , ,117,82,35
2012,Sierra County,20,16,10,6, , , ,20,16,10,6, , , ,16,10,6, , , , , , ,2,1,0,1,0, , , , , ,2,2,0
2012,Siskiyou County,220,156,117,39, , , ,220,156,117,39, , , ,101,77,24,55,40,15, , , ,24,8,2,9,5,8,5,0,3,0,32,14,18
2012,Solano County,1332,975,489,486,4,3,1,1332,975,489,486,4,3,1,409,104,305,562,382,180, , , ,109,50,9,32,18,68,43,10,11,4,180,145,35
2012,Sonoma County,1500,1097,574,523,47,24,23,1500,1097,574,523,47,24,23,589,223,366,461,327,134, , , ,112,48,14,33,17,48,28,8,11,1,243,197,46
2012,Stanislaus County,1419,1058,778,280,21,12,9,1419,1058,778,280,21,12,9,518,388,130,519,378,141, , , ,104,40,11,29,24,35,23,1,9,2,222,175,47
2012,Sutter County,281,215,168,47, , , ,281,215,168,47, , , ,129,104,25,86,64,22, , , ,25,9,8,8,0, , , , , ,41,34,7
2012,Tehama County,230,159,108,51, , , ,230,159,108,51, , , ,104,72,32,55,36,19, , , ,22,8,5,7,2, , , , , ,49,39,10
2012,Trinity County,72,40,18,22, , , ,72,40,18,22, , , ,40,18,22, , , , , , ,11,4,1,4,2, , , , , ,21,17,4
2012,Tulare County,1800,1180,862,318,7,6,1,1800,1180,862,318,7,6,1,688,501,187,485,355,130, , , ,171,58,50,42,21,77,43,8,13,13,372,265,107
2012,Tuolumne County,185,135,70,65, , , ,185,135,70,65, , , ,119,58,61,16,12,4, , , ,17,6,2,5,4,6,4,1,1,0,27,16,11
2012,Ventura County,2810,2065,1302,763,40,28,12,2810,2065,1302,763,40,28,12,1219,748,471,806,526,280, , , ,241,93,50,49,49,87,53,13,12,9,417,321,96
2012,Yolo County,791,559,321,238,72,47,25,791,559,321,238,72,47,25,227,83,144,260,191,69, , , ,81,33,20,17,11,31,22,4,5,0,120,103,17
2012,Yuba County,320,208,157,51, , , ,320,208,157,51, , , ,172,132,40,36,25,11, , , ,15,9,2,4,0, , , , , ,97,34,63
2013,Alameda County,5363,4315,2768,1547,250,134,116,5363,4315,2768,1547,250,134,116,1599,938,661,2466,1696,770, , , ,343,148,54,105,36,162,100,18,35,9,543,188,355
2013,Alpine County,20,18,15,3, , , ,20,18,15,3, , , ,18,15,3, , , , , , ,2,1,0,0,1,0,0,0,0,0,0,0,0
2013,Amador County,147,106,61,45, , , ,147,106,61,45, , , ,86,42,44,20,19,1, , , ,22,7,7,6,2,0,0,0,0,0,19,14,5
2013,Butte County,792,544,264,280,27,16,11,792,544,264,280,27,16,11,299,109,190,218,139,79, , , ,93,28,27,25,13,0,0,0,0,0,155,69,86
2013,Calaveras County,133,105,62,43, , , ,133,105,62,43, , , ,97,55,42,8,7,1, , , ,14,7,1,5,1,0,0,0,0,0,14,8,6
2013,Colusa County,120,89,52,37, , , ,120,89,52,37, , , ,67,33,34,22,19,3, , , ,11,3,2,3,3,0,0,0,0,0,20,13,7
2013,Contra Costa County,3112,2516,1780,736,295,198,97,2851,2255,1605,650,34,23,11,965,654,311,1256,928,328, , , ,152,88,15,31,18,114,72,11,15,16,330,234,96
2013,Del Norte County,122,66,35,31, , , ,122,66,35,31, , , ,53,24,29,13,11,2, , , ,11,5,2,4,0,0,0,0,0,0,45,37,8
2013,El Dorado County,613,421,210,211, , , ,613,421,210,211, , , ,339,156,183,82,54,28, , , ,57,21,11,13,12,18,12,2,4,0,117,92,25
2013,Fresno County,3416,2598,2066,532,283,255,28,3416,2598,2066,532,283,255,28,1005,813,192,1310,998,312, , , ,216,104,44,60,8,87,54,9,17,7,515,387,128
2013,Glenn County,110,80,42,38, , , ,110,80,42,38, , , ,60,25,35,20,17,3, , , ,5,2,0,3,0,0,0,0,0,0,25,11,14
2013,Humboldt County,555,381,280,101,19,12,7,555,381,280,101,19,12,7,213,169,44,149,99,50, , , ,48,13,11,16,8,25,14,3,8,0,101,75,26
2013,Imperial County,644,465,322,143, , , ,644,465,322,143, , , ,268,182,86,197,140,57, , , ,63,20,13,18,12,24,14,4,6,0,92,74,18
2013,Inyo County,118,71,46,25, , , ,118,71,46,25, , , ,53,34,19,18,12,6, , , ,13,4,3,4,2,0,0,0,0,0,34,25,9
2013,Kern County,2890,2011,1479,532,15,11,4,2890,2011,1479,532,15,11,4,1239,942,297,757,526,231, , , ,183,91,36,46,10,87,57,12,16,2,609,493,116
2013,Kings County,583,413,196,217, , , ,583,413,196,217, , , ,251,79,172,162,117,45, , , ,54,19,14,17,4,0,0,0,0,0,116,93,23
2013,Lake County,261,186,81,105, , , ,261,186,81,105, , , ,147,51,96,39,30,9, , , ,30,14,6,9,1,0,0,0,0,0,45,37,8
2013,Lassen County,141,90,70,20, , , ,141,90,70,20, , , ,74,55,19,16,15,1, , , ,11,4,1,4,2,5,3,0,2,0,35,15,20
2013,Los Angeles County,44443,36057,23551,12506,294,187,107,44443,36057,23551,12506,294,187,107,16704,9186,7518,19059,14178,4881, , , ,1969,960,263,471,275,1031,704,73,138,116,5386,4038,1348
2013,Madera County,337,201,143,58, , , ,337,201,143,58, , , ,103,71,32,98,72,26, , , ,32,17,5,7,3,0,0,0,0,0,104,83,21
2013,Marin County,833,613,444,169,8,7,1,833,613,444,169,8,7,1,293,195,98,312,242,70, , , ,78,30,8,24,16,37,22,4,8,3,105,77,28
2013,Mariposa County,90,65,52,13, , , ,90,65,52,13, , , ,65,52,13, , , , , , ,10,4,1,4,1,0,0,0,0,0,15,11,4
2013,Mendocino County,384,237,175,62, , , ,384,237,175,62, , , ,157,120,37,80,55,25, , , ,51,18,6,18,9,24,14,3,4,3,72,55,17
2013,Merced County,728,500,296,204,25,12,13,728,500,296,204,25,12,13,225,106,119,250,178,72, , , ,67,23,13,24,7,19,12,4,3,0,142,118,24
2013,Modoc County,43,35,19,16, , , ,43,35,19,16, , , ,28,13,15,7,6,1, , , ,3,0,1,0,2,0,0,0,0,0,5,4,1
2013,Mono County,88,71,39,32, , , ,88,71,39,32, , , ,57,28,29,14,11,3, , , ,8,4,2,2,0,0,0,0,0,0,9,7,2
2013,Monterey County,1329,864,657,207,26,20,6,1329,864,657,207,26,20,6,382,281,101,456,356,100, , , ,130,50,25,41,14,55,35,7,10,3,280,207,73
2013,Napa County,581,389,297,92,117,105,12,581,389,297,92,117,105,12,133,104,29,139,88,51, , , ,54,23,8,15,8,22,14,3,5,0,116,92,24
2013,Nevada County,328,232,118,114, , , ,328,232,118,114, , , ,160,63,97,72,55,17, , , ,24,10,3,10,1,12,8,0,4,0,60,46,14
2013,Orange County,9784,7413,4379,3034,86,60,26,9784,7413,4379,3034,86,60,26,3663,1901,1762,3664,2418,1246, , , ,750,285,179,122,164,386,208,73,56,49,1235,866,369
2013,Placer County,1022,775,446,329, , , ,1022,775,446,329, , , ,459,234,225,316,212,104, , , ,102,40,13,39,10,0,0,0,0,0,145,118,27
2013,Plumas County,77,58,30,28, , , ,77,58,30,28, , , ,58,30,28, , , , , , ,8,3,2,2,1,0,0,0,0,0,11,6,5
2013,Riverside County,7077,5360,3083,2277,71,52,19,7077,5360,3083,2277,71,52,19,3897,2053,1844,1392,978,414, , , ,698,246,109,224,119,222,124,29,41,28,797,561,236
2013,Sacramento County,15783,14599,10016,4583,782,683,99,4445,3261,2142,1119,67,45,22,1850,1177,673,1344,920,424,10623,7236,3387,391,167,39,67,118,145,100,23,17,5,648,534,114
2013,San Benito County,105,68,41,27, , , ,105,68,41,27, , , ,39,17,22,29,24,5, , , ,8,4,2,2,0,0,0,0,0,0,29,24,5
2013,San Bernardino County,7053,5143,2964,2179,250,114,136,7053,5143,2964,2179,250,114,136,3228,1742,1486,1665,1108,557, , , ,463,201,65,129,68,215,121,33,49,12,1232,901,331
2013,San Diego County,10680,8127,5399,2728,293,194,99,10680,8127,5399,2728,293,194,99,3954,2361,1593,3880,2844,1036, , , ,929,317,155,239,218,348,219,47,54,28,1276,1013,263
2013,San Francisco County,4631,3772,3079,693,183,88,95,4631,3772,3079,693,183,88,95,1012,841,171,2577,2150,427, , , ,247,125,28,11,83,142,83,14,21,24,470,167,303
2013,San Joaquin County,2093,1592,890,702,27,21,6,2093,1592,890,702,27,21,6,700,276,424,865,593,272, , , ,165,66,30,45,24,70,42,13,11,4,266,216,50
2013,San Luis Obispo County,1073,836,492,344,175,139,36,1073,836,492,344,175,139,36,381,153,228,280,200,80, , , ,91,34,15,23,19,0,0,0,0,0,146,105,41
2013,San Mateo County,2100,1601,1045,556, , , ,2100,1601,1045,556, , , ,619,320,299,982,725,257, , , ,121,54,12,39,16,0,0,0,0,0,378,293,85
2013,Santa Barbara County,1633,1096,756,340,59,36,23,1633,1096,756,340,59,36,23,606,429,177,431,291,140, , , ,120,48,17,40,15,62,36,8,14,4,355,257,98
2013,Santa Clara County,5862,4259,3031,1228,110,52,58,5862,4259,3031,1228,110,52,58,1572,1115,457,2577,1864,713, , , ,482,178,72,122,110,238,121,30,38,49,883,361,522
2013,Santa Cruz County,779,573,343,230,23,13,10,779,573,343,230,23,13,10,304,135,169,246,195,51, , , ,82,32,13,23,14,0,0,0,0,0,124,98,26
2013,Shasta County,572,393,273,120,22,18,4,572,393,273,120,22,18,4,220,142,78,151,113,38, , , ,60,21,13,12,14,0,0,0,0,0,119,85,34
2013,Sierra County,20,16,10,6, , , ,20,16,10,6, , , ,16,10,6, , , , , , ,2,1,0,1,0,0,0,0,0,0,2,2,0
2013,Siskiyou County,214,146,111,35, , , ,214,146,111,35, , , ,93,74,19,53,37,16, , , ,24,8,2,9,5,8,5,0,3,0,36,14,22
2013,Solano County,1333,965,482,483,2,1,1,1333,965,482,483,2,1,1,418,109,309,545,372,173, , , ,109,50,9,33,17,72,47,9,13,3,187,152,35
2013,Sonoma County,1518,1086,576,510,46,25,21,1518,1086,576,510,46,25,21,581,228,353,459,323,136, , , ,114,48,14,34,18,49,29,8,11,1,269,215,54
2013,Stanislaus County,1442,1063,785,278,20,11,9,1442,1063,785,278,20,11,9,535,402,133,508,372,136, , , ,112,42,12,32,26,37,24,1,10,2,230,180,50
2013,Sutter County,279,209,163,46, , , ,279,209,163,46, , , ,128,105,23,81,58,23, , , ,23,10,6,4,3,0,0,0,0,0,47,40,7
2013,Tehama County,243,169,119,50, , , ,243,169,119,50, , , ,114,81,33,55,38,17, , , ,25,8,6,9,2,0,0,0,0,0,49,36,13
2013,Trinity County,74,40,32,8, , , ,74,40,32,8, , , ,40,32,8, , , , , , ,10,3,1,4,2,0,0,0,0,0,24,20,4
2013,Tulare County,1897,1250,904,346,8,7,1,1897,1250,904,346,8,7,1,729,532,197,513,365,148, , , ,174,61,52,39,22,81,43,8,15,15,392,282,110
2013,Tuolumne County,202,145,74,71, , , ,202,145,74,71, , , ,125,61,64,20,13,7, , , ,17,5,2,6,4,6,4,1,1,0,34,20,14
2013,Ventura County,2799,2052,1314,738,41,29,12,2799,2052,1314,738,41,29,12,1227,757,470,784,528,256, , , ,248,95,51,50,52,92,55,12,12,13,407,308,99
2013,Yolo County,820,593,318,275,89,45,44,820,593,318,275,89,45,44,242,84,158,262,189,73, , , ,86,36,20,20,10,31,22,4,5,0,110,93,17
2013,Yuba County,309,202,150,52, , , ,309,202,150,52, , , ,165,124,41,37,26,11, , , ,14,9,2,3,0,0,0,0,0,0,93,32,61
2014,Alameda County,5509,4451,2883,1568,257,139,118,5509,4451,2883,1568,257,139,118,1506,956,550,2688,1788,900, , , ,343,148,54,105,36,163,101,18,35,9,552,191,361
2014,Alpine County,17,14,11,3, , , ,17,14,11,3, , , ,14,11,3, , , , , , ,3,1,0,1,1,0,0,0,0,0,0,0,0
2014,Amador County,156,115,68,47, , , ,156,115,68,47, , , ,93,47,46,22,21,1, , , ,23,8,7,6,2,0,0,0,0,0,18,14,4
2014,Butte County,778,528,255,273,27,16,11,778,528,255,273,27,16,11,296,109,187,205,130,75, , , ,91,30,25,25,11,0,0,0,0,0,159,79,80
2014,Calaveras County,131,100,55,45, , , ,131,100,55,45, , , ,92,48,44,8,7,1, , , ,14,7,1,5,1,0,0,0,0,0,17,10,7
2014,Colusa County,121,90,54,36, , , ,121,90,54,36, , , ,67,34,33,23,20,3, , , ,10,3,2,3,2,0,0,0,0,0,21,12,9
2014,Contra Costa County,3165,2522,1784,738,312,208,104,2885,2242,1597,645,32,21,11,940,639,301,1270,937,333, , , ,185,97,37,35,16,119,76,10,18,15,339,275,64
2014,Del Norte County,118,66,37,29, , , ,118,66,37,29, , , ,53,25,28,13,12,1, , , ,11,5,2,4,0,0,0,0,0,0,41,33,8
2014,El Dorado County,624,417,205,212, , , ,624,417,205,212, , , ,341,155,186,76,50,26, , , ,56,21,13,12,10,24,14,4,5,1,127,101,26
2014,Fresno County,3464,2634,1638,996,281,251,30,3464,2634,1638,996,281,251,30,1009,398,611,1344,989,355, , , ,234,110,44,68,12,87,54,9,17,7,509,380,129
2014,Glenn County,114,81,43,38, , , ,114,81,43,38, , , ,60,25,35,21,18,3, , , ,4,1,0,2,1,0,0,0,0,0,29,12,17
2014,Humboldt County,568,386,287,99,17,12,5,568,386,287,99,17,12,5,219,175,44,150,100,50, , , ,50,14,10,12,14,25,14,3,8,0,107,84,23
2014,Imperial County,662,472,322,150, , , ,662,472,322,150, , , ,284,190,94,188,132,56, , , ,69,21,14,19,15,25,15,4,6,0,96,76,20
2014,Inyo County,131,86,47,39, , , ,131,86,47,39, , , ,68,35,33,18,12,6, , , ,13,4,3,4,2,0,0,0,0,0,32,23,9
2014,Kern County,2983,2070,1520,550,17,11,6,2983,2070,1520,550,17,11,6,1191,886,305,862,623,239, , , ,201,94,43,45,19,95,63,12,18,2,617,502,115
2014,Kings County,603,428,191,237, , , ,603,428,191,237, , , ,267,76,191,161,115,46, , , ,60,20,16,18,6,0,0,0,0,0,115,90,25
2014,Lake County,248,172,80,92, , , ,248,172,80,92, , , ,134,50,84,38,30,8, , , ,31,15,5,10,1,0,0,0,0,0,45,37,8
2014,Lassen County,147,100,77,23, , , ,147,100,77,23, , , ,82,61,21,18,16,2, , , ,11,4,1,4,2,5,3,0,2,0,31,9,22
2014,Los Angeles County,44626,36241,23631,12610,302,183,119,44626,36241,23631,12610,302,183,119,16759,9220,7539,19180,14228,4952, , , ,2021,965,272,487,297,1034,697,80,146,111,5330,3985,1345
2014,Madera County,336,202,143,59, , , ,336,202,143,59, , , ,109,75,34,93,68,25, , , ,30,15,7,7,1,0,0,0,0,0,104,84,20
2014,Marin County,828,604,430,174,8,7,1,828,604,430,174,8,7,1,282,187,95,314,236,78, , , ,83,30,8,27,18,38,23,4,8,3,103,73,30
2014,Mariposa County,97,72,58,14, , , ,97,72,58,14, , , ,72,58,14, , , , , , ,10,4,1,4,1,0,0,0,0,0,15,11,4
2014,Mendocino County,397,255,183,72, , , ,397,255,183,72, , , ,168,126,42,87,57,30, , , ,51,18,6,18,9,24,14,3,4,3,67,51,16
2014,Merced County,738,506,297,209,24,12,12,738,506,297,209,24,12,12,221,97,124,261,188,73, , , ,68,23,13,24,8,16,13,0,3,0,148,132,16
2014,Modoc County,39,30,21,9, , , ,39,30,21,9, , , ,21,13,8,9,8,1, , , ,5,2,0,1,2,0,0,0,0,0,4,3,1
2014,Mono County,80,63,37,26, , , ,80,63,37,26, , , ,49,26,23,14,11,3, , , ,8,4,2,2,0,0,0,0,0,0,9,7,2
2014,Monterey County,1362,877,653,224,25,19,6,1362,877,653,224,25,19,6,414,300,114,438,334,104, , , ,142,50,27,49,16,56,36,7,10,3,287,208,79
2014,Napa County,601,409,313,96,119,109,10,601,409,313,96,119,109,10,142,112,30,148,92,56, , , ,54,23,8,15,8,23,14,3,5,1,115,92,23
2014,Nevada County,316,226,116,110, , , ,316,226,116,110, , , ,153,59,94,73,57,16, , , ,24,10,3,10,1,12,8,0,4,0,54,40,14
2014,Orange County,9664,7330,4280,3050,83,57,26,9664,7330,4280,3050,83,57,26,3601,1828,1773,3646,2395,1251, , , ,734,290,163,117,164,383,207,71,57,48,1217,850,367
2014,Placer County,1028,783,446,337, , , ,1028,783,446,337, , , ,465,236,229,318,210,108, , , ,101,40,12,41,8,0,0,0,0,0,144,118,26
2014,Plumas County,81,61,32,29, , , ,81,61,32,29, , , ,61,32,29, , , , , , ,8,3,1,3,1,0,0,0,0,0,12,5,7
2014,Riverside County,7193,5464,3018,2446,64,46,18,7193,5464,3018,2446,64,46,18,4020,2009,2011,1380,963,417, , , ,700,250,105,225,120,213,115,32,47,19,816,590,226
2014,Sacramento County,15775,14609,10102,4507,758,668,90,4537,3371,2206,1165,71,47,24,1900,1213,687,1400,946,454,10551,7275,3276,390,167,39,67,117,143,97,23,17,6,633,522,111
2014,San Benito County,109,73,43,30, , , ,109,73,43,30, , , ,42,18,24,31,25,6, , , ,9,4,2,3,0,0,0,0,0,0,27,24,3
2014,San Bernardino County,7101,5215,3038,2177,267,125,142,7101,5215,3038,2177,267,125,142,3310,1809,1501,1638,1104,534, , , ,440,178,64,128,70,229,123,31,45,30,1217,895,322
2014,San Diego County,10978,8330,5582,2748,294,199,95,10978,8330,5582,2748,294,199,95,4123,2515,1608,3913,2868,1045, , , ,952,321,168,240,223,357,222,48,54,33,1339,1062,277
2014,San Francisco County,4624,3766,3054,712,188,90,98,4624,3766,3054,712,188,90,98,990,827,163,2588,2137,451, , , ,248,128,30,11,79,148,83,18,24,23,462,167,295
2014,San Joaquin County,2192,1650,931,719,27,20,7,2192,1650,931,719,27,20,7,721,290,431,902,621,281, , , ,177,75,30,47,25,73,44,13,11,5,292,225,67
2014,San Luis Obispo County,1065,822,489,333,176,140,36,1065,822,489,333,176,140,36,379,151,228,267,198,69, , , ,91,34,15,23,19,0,0,0,0,0,152,111,41
2014,San Mateo County,2087,1611,1193,418, , , ,2087,1611,1193,418, , , ,638,462,176,973,731,242, , , ,119,53,12,35,19,0,0,0,0,0,357,293,64
2014,Santa Barbara County,1630,1117,797,320,62,39,23,1630,1117,797,320,62,39,23,612,446,166,443,312,131, , , ,123,49,16,40,18,62,32,7,19,4,328,232,96
2014,Santa Clara County,5926,4283,2993,1290,105,49,56,5926,4283,2993,1290,105,49,56,1616,1166,450,2562,1778,784, , , ,507,182,78,138,109,243,124,32,42,45,893,365,528
2014,Santa Cruz County,795,585,346,239,30,17,13,795,585,346,239,30,17,13,304,135,169,251,194,57, , , ,83,33,13,23,14,0,0,0,0,0,127,102,25
2014,Shasta County,574,389,275,114,24,19,5,574,389,275,114,24,19,5,217,145,72,148,111,37, , , ,62,24,15,11,12,0,0,0,0,0,123,89,34
2014,Sierra County,21,15,10,5, , , ,21,15,10,5, , , ,15,10,5, , , , , , ,2,1,0,1,0,0,0,0,0,0,4,3,1
2014,Siskiyou County,219,151,115,36, , , ,219,151,115,36, , , ,100,79,21,51,36,15, , , ,24,8,2,9,5,8,5,0,3,0,36,29,7
2014,Solano County,1416,1029,510,519, , , ,1416,1029,510,519, , , ,457,116,341,572,394,178, , , ,115,48,16,31,20,72,47,9,13,3,200,166,34
2014,Sonoma County,1584,1131,584,547,51,26,25,1584,1131,584,547,51,26,25,612,228,384,468,330,138, , , ,118,49,14,37,18,49,29,8,11,1,286,221,65
2014,Stanislaus County,1462,1074,774,300,19,11,8,1462,1074,774,300,19,11,8,564,409,155,491,354,137, , , ,115,42,13,36,24,37,24,1,10,2,236,186,50
2014,Sutter County,284,213,165,48, , , ,284,213,165,48, , , ,132,108,24,81,57,24, , , ,23,9,6,4,4,0,0,0,0,0,48,39,9
2014,Tehama County,248,168,119,49, , , ,248,168,119,49, , , ,115,83,32,53,36,17, , , ,24,8,6,9,1,0,0,0,0,0,56,43,13
2014,Trinity County,68,40,33,7, , , ,68,40,33,7, , , ,40,33,7, , , , , , ,7,2,1,2,2,0,0,0,0,0,21,17,4
2014,Tulare County,1942,1275,911,364,7,6,1,1942,1275,911,364,7,6,1,749,536,213,519,369,150, , , ,191,64,48,40,39,81,44,8,14,15,395,285,110
2014,Tuolumne County,200,145,74,71, , , ,200,145,74,71, , , ,126,61,65,19,13,6, , , ,18,7,1,6,4,6,4,1,1,0,31,19,12
2014,Ventura County,2808,2040,1312,728,41,28,13,2808,2040,1312,728,41,28,13,1231,747,484,768,537,231, , , ,253,95,53,48,57,94,56,13,13,12,421,325,96
2014,Yolo County,836,607,327,280,89,45,44,836,607,327,280,89,45,44,254,88,166,264,194,70, , , ,86,34,22,20,10,33,22,4,6,1,110,93,17
2014,Yuba County,309,200,147,53, , , ,309,200,147,53, , , ,168,125,43,32,22,10, , , ,14,9,2,3,0,0,0,0,0,0,95,32,63
2015,Alameda County,5508,4447,2920,1527,258,139,119,5508,4447,2920,1527,258,139,119,1560,978,582,2629,1803,826, , , ,343,148,54,105,36,161,101,23,34,3,557,191,366
2015,Alpine County,20,16,13,3, , , ,20,16,13,3, , , ,16,13,3, , , , , , ,3,1,0,1,1,0,0,0,0,0,1,0,1
2015,Amador County,160,120,74,46, , , ,160,120,74,46, , , ,100,55,45,20,19,1, , , ,22,8,7,5,2,0,0,0,0,0,18,14,4
2015,Butte County,799,542,260,282,25,14,11,799,542,260,282,25,14,11,288,101,187,229,145,84, , , ,96,30,19,31,16,0,0,0,0,0,161,71,90
2015,Calaveras County,131,100,52,48, , , ,131,100,52,48, , , ,92,45,47,8,7,1, , , ,14,7,1,5,1,0,0,0,0,0,17,10,7
2015,Colusa County,110,79,45,34, , , ,110,79,45,34, , , ,59,28,31,20,17,3, , , ,12,4,3,3,2,0,0,0,0,0,19,10,9
2015,Contra Costa County,3099,2516,1773,743,319,218,101,2814,2231,1576,655,34,21,13,936,610,326,1261,945,316, , , ,170,94,21,45,10,119,76,10,18,15,294,234,60
2015,Del Norte County,113,65,36,29, , , ,113,65,36,29, , , ,53,25,28,12,11,1, , , ,10,5,1,4,0,0,0,0,0,0,38,31,7
2015,El Dorado County,620,422,214,208, , , ,620,422,214,208, , , ,349,164,185,73,50,23, , , ,54,20,16,12,6,23,14,3,5,1,121,97,24
2015,Fresno County,3588,2712,1650,1062,292,242,50,3588,2712,1650,1062,292,242,50,1043,406,637,1377,1002,375, , , ,260,116,52,74,18,94,58,13,17,6,522,394,128
2015,Glenn County,111,78,41,37, , , ,111,78,41,37, , , ,56,20,36,22,21,1, , , ,5,1,0,4,0,0,0,0,0,0,28,25,3
2015,Humboldt County,550,382,287,95,19,12,7,550,382,287,95,19,12,7,224,177,47,139,98,41, , , ,51,16,11,16,8,25,14,3,8,0,92,65,27
2015,Imperial County,669,478,327,151, , , ,669,478,327,151, , , ,283,190,93,195,137,58, , , ,71,22,15,18,16,26,16,4,6,0,94,76,18
2015,Inyo County,133,90,50,40, , , ,133,90,50,40, , , ,71,37,34,19,13,6, , , ,11,4,3,3,1,0,0,0,0,0,32,25,7
2015,Kern County,3011,2085,1526,559,21,14,7,3011,2085,1526,559,21,14,7,1181,868,313,883,644,239, , , ,208,96,42,50,20,92,62,10,18,2,626,481,145
2015,Kings County,596,421,194,227, , , ,596,421,194,227, , , ,258,77,181,163,117,46, , , ,57,21,14,19,3,0,0,0,0,0,118,91,27
2015,Lake County,256,173,82,91, , , ,256,173,82,91, , , ,135,51,84,38,31,7, , , ,31,15,5,10,1,0,0,0,0,0,52,43,9
2015,Lassen County,143,99,74,25, , , ,143,99,74,25, , , ,82,59,23,17,15,2, , , ,10,4,1,3,2,5,3,0,2,0,29,11,18
2015,Los Angeles County,44470,35919,23519,12400,296,193,103,44470,35919,23519,12400,296,193,103,16582,9146,7436,19041,14180,4861, , , ,2046,972,270,501,303,1040,688,73,157,122,5465,4041,1424
2015,Madera County,426,201,147,54, , , ,426,201,147,54, , , ,104,75,29,97,72,25, , , ,34,16,7,9,2,0,0,0,0,0,191,107,84
2015,Marin County,834,611,441,170,7,6,1,834,611,441,170,7,6,1,293,194,99,311,241,70, , , ,81,30,9,23,19,36,22,4,9,1,106,77,29
2015,Mariposa County,99,72,58,14, , , ,99,72,58,14, , , ,72,58,14, , , , , , ,10,4,1,4,1,0,0,0,0,0,17,13,4
2015,Mendocino County,393,247,175,72, , , ,393,247,175,72, , , ,162,117,45,85,58,27, , , ,51,18,6,18,9,27,16,4,4,3,68,52,16
2015,Merced County,704,488,277,211,20,12,8,704,488,277,211,20,12,8,210,82,128,258,183,75, , , ,63,23,8,24,8,17,14,0,2,1,136,115,21
2015,Modoc County,38,29,19,10, , , ,38,29,19,10, , , ,23,14,9,6,5,1, , , ,5,2,0,0,3,0,0,0,0,0,4,3,1
2015,Mono County,72,54,33,21, , , ,72,54,33,21, , , ,40,22,18,14,11,3, , , ,8,4,2,2,0,0,0,0,0,0,10,7,3
2015,Monterey County,1350,879,646,233,30,21,9,1350,879,646,233,30,21,9,403,291,112,446,334,112, , , ,143,59,30,47,7,56,36,7,10,3,272,204,68
2015,Napa County,569,389,302,87,114,107,7,569,389,302,87,114,107,7,132,103,29,143,92,51, , , ,50,22,8,15,5,23,14,3,5,1,107,85,22
2015,Nevada County,323,227,116,111, , , ,323,227,116,111, , , ,155,59,96,72,57,15, , , ,26,10,3,10,3,12,8,0,4,0,58,44,14
2015,Orange County,9737,7404,4317,3087,91,60,31,9737,7404,4317,3087,91,60,31,3602,1778,1824,3711,2479,1232, , , ,776,277,239,133,127,374,198,75,56,45,1183,826,357
2015,Placer County,1039,791,453,338, , , ,1039,791,453,338, , , ,471,233,238,320,220,100, , , ,104,41,19,33,11,0,0,0,0,0,144,118,26
2015,Plumas County,80,60,32,28, , , ,80,60,32,28, , , ,60,32,28, , , , , , ,8,3,1,3,1,0,0,0,0,0,12,5,7
2015,Riverside County,7315,5542,3065,2477,67,49,18,7315,5542,3065,2477,67,49,18,4088,2049,2039,1387,967,420, , , ,677,244,106,214,113,221,125,30,46,20,875,631,244
2015,Sacramento County,15711,14470,10089,4381,727,655,72,4638,3397,2255,1142,68,47,21,1906,1249,657,1423,959,464,10414,7226,3188,406,172,40,69,125,145,100,23,15,7,690,368,322
2015,San Benito County,123,86,52,34, , , ,123,86,52,34, , , ,53,25,28,33,27,6, , , ,10,5,2,2,1,0,0,0,0,0,27,20,7
2015,San Bernardino County,7074,5206,3078,2128,270,130,140,7074,5206,3078,2128,270,130,140,3247,1824,1423,1689,1124,565, , , ,440,178,64,128,70,214,126,29,46,13,1214,893,321
2015,San Diego County,10917,8339,5629,2710,291,204,87,10917,8339,5629,2710,291,204,87,4127,2558,1569,3921,2867,1054, , , ,957,319,167,239,232,362,225,48,52,37,1259,985,274
2015,San Francisco County,4740,3849,3122,727,178,79,99,4740,3849,3122,727,178,79,99,960,807,153,2711,2236,475, , , ,270,135,35,5,95,161,91,18,24,28,460,165,295
2015,San Joaquin County,2220,1651,936,715,27,20,7,2220,1651,936,715,27,20,7,702,280,422,922,636,286, , , ,192,81,34,45,32,79,48,13,15,3,298,224,74
2015,San Luis Obispo County,1074,834,625,209,184,152,32,1074,834,625,209,184,152,32,385,282,103,265,191,74, , , ,93,34,15,25,19,0,0,0,0,0,147,109,38
2015,San Mateo County,2131,1645,1046,599, , , ,2131,1645,1046,599, , , ,662,308,354,983,738,245, , , ,106,53,14,34,5,0,0,0,0,0,380,289,91
2015,Santa Barbara County,1618,1106,779,327,60,42,18,1618,1106,779,327,60,42,18,610,442,168,436,295,141, , , ,127,50,16,38,23,60,32,7,16,5,325,228,97
2015,Santa Clara County,5910,4239,3024,1215,116,52,64,5910,4239,3024,1215,116,52,64,1613,1206,407,2510,1766,744, , , ,517,185,76,132,124,257,126,33,50,48,897,362,535
2015,Santa Cruz County,793,585,359,226,30,18,12,793,585,359,226,30,18,12,299,143,156,256,198,58, , , ,85,36,13,24,12,0,0,0,0,0,123,99,24
2015,Shasta County,559,387,278,109,24,20,4,559,387,278,109,24,20,4,210,142,68,153,116,37, , , ,64,23,14,17,10,0,0,0,0,0,108,80,28
2015,Sierra County,20,14,10,4, , , ,20,14,10,4, , , ,14,10,4, , , , , , ,2,1,0,1,0,0,0,0,0,0,4,3,1
2015,Siskiyou County,219,152,117,35, , , ,219,152,117,35, , , ,99,78,21,53,39,14, , , ,24,8,2,8,6,6,3,0,3,0,37,28,9
2015,Solano County,1444,1064,522,542, , , ,1444,1064,522,542, , , ,481,123,358,583,399,184, , , ,120,51,19,32,18,57,36,7,12,2,203,166,37
2015,Sonoma County,1565,1123,591,532,53,27,26,1565,1123,591,532,53,27,26,593,231,362,477,333,144, , , ,121,51,14,39,17,49,29,10,10,0,272,218,54
2015,Stanislaus County,1520,1114,813,301,17,11,6,1520,1114,813,301,17,11,6,582,432,150,515,370,145, , , ,116,43,15,31,27,40,28,1,10,1,250,102,148
2015,Sutter County,274,208,165,43, , , ,274,208,165,43, , , ,130,111,19,78,54,24, , , ,23,10,5,4,4,0,0,0,0,0,43,37,6
2015,Tehama County,252,167,118,49, , , ,252,167,118,49, , , ,115,83,32,52,35,17, , , ,24,8,6,8,2,0,0,0,0,0,61,47,14
2015,Trinity County,68,42,34,8, , , ,68,42,34,8, , , ,42,34,8, , , , , , ,10,4,1,3,2,0,0,0,0,0,16,12,4
2015,Tulare County,1960,1288,906,382,5,4,1,1960,1288,906,382,5,4,1,779,544,235,504,358,146, , , ,188,65,56,37,30,86,44,11,15,16,398,287,111
2015,Tuolumne County,202,148,75,73, , , ,202,148,75,73, , , ,129,62,67,19,13,6, , , ,18,7,1,6,4,6,4,1,1,0,30,20,10
2015,Ventura County,2855,2052,1295,757,44,29,15,2855,2052,1295,757,44,29,15,1242,732,510,766,534,232, , , ,252,97,52,50,53,98,58,15,13,12,453,316,137
2015,Yolo County,824,603,321,282,83,43,40,824,603,321,282,83,43,40,262,91,171,258,187,71, , , ,87,33,13,28,13,35,23,4,6,2,99,76,23
2015,Yuba County,300,199,149,50, , , ,300,199,149,50, , , ,168,126,42,31,23,8, , , ,14,9,2,2,1,0,0,0,0,0,87,57,30
2016,Alameda County,5570,4476,2983,1493,236,133,103,5570,4476,2983,1493,236,133,103,1564,1003,561,2676,1847,829, , , ,390,151,67,172,0,170,104,18,39,9,534,178,356
2016,Alpine County,20,17,13,4, , , ,20,17,13,4, , , ,17,13,4, , , , , , ,2,1,0,0,1,0,0,0,0,0,1,0,1
2016,Amador County,147,107,65,42, , , ,147,107,65,42, , , ,86,45,41,21,20,1, , , ,23,8,8,5,2,0,0,0,0,0,17,13,4
2016,Butte County,785,529,253,276,27,16,11,785,529,253,276,27,16,11,269,94,175,233,143,90, , , ,92,31,18,23,20,0,0,0,0,0,164,74,90
2016,Calaveras County,142,108,55,53, , , ,142,108,55,53, , , ,101,49,52,7,6,1, , , ,16,7,2,5,2,0,0,0,0,0,18,11,7
2016,Colusa County,115,83,48,35, , , ,115,83,48,35, , , ,65,33,32,18,15,3, , , ,13,4,4,3,2,0,0,0,0,0,19,10,9
2016,Contra Costa County,3101,2517,1788,729,311,211,100,2824,2240,1599,641,34,22,12,957,633,324,1249,944,305, , , ,171,94,21,37,19,119,76,10,18,15,294,234,60
2016,Del Norte County,120,65,33,32, , , ,120,65,33,32, , , ,55,24,31,10,9,1, , , ,14,5,2,4,3,0,0,0,0,0,41,33,8
2016,El Dorado County,623,431,209,222, , , ,623,431,209,222, , , ,349,154,195,82,55,27, , , ,54,20,18,12,4,22,14,4,4,0,116,91,25
2016,Fresno County,3719,2834,1714,1120,285,248,37,3719,2834,1714,1120,285,248,37,1104,406,698,1445,1060,385, , , ,239,107,49,63,20,113,69,15,21,8,533,409,124
2016,Glenn County,110,78,42,36, , , ,110,78,42,36, , , ,55,22,33,23,20,3, , , ,6,2,0,4,0,0,0,0,0,0,26,12,14
2016,Humboldt County,571,395,290,105,20,12,8,571,395,290,105,20,12,8,235,182,53,140,96,44, , , ,57,18,12,15,12,25,14,3,8,0,94,70,24
2016,Imperial County,669,472,323,149, , , ,669,472,323,149, , , ,286,190,96,186,133,53, , , ,70,22,15,21,12,26,16,4,6,0,101,79,22
2016,Inyo County,130,87,45,42, , , ,130,87,45,42, , , ,71,35,36,16,10,6, , , ,11,4,3,3,1,0,0,0,0,0,32,25,7
2016,Kern County,2891,1982,1428,554,21,13,8,2891,1982,1428,554,21,13,8,1137,826,311,824,589,235, , , ,214,94,47,53,20,98,62,12,23,1,597,466,131
2016,Kings County,604,432,191,241, , , ,604,432,191,241, , , ,271,75,196,161,116,45, , , ,57,21,16,18,2,0,0,0,0,0,115,95,20
2016,Lake County,245,176,88,88, , , ,245,176,88,88, , , ,135,53,82,41,35,6, , , ,31,15,6,9,1,0,0,0,0,0,38,29,9
2016,Lassen County,146,100,76,24, , , ,146,100,76,24, , , ,81,59,22,19,17,2, , , ,11,6,1,3,1,5,3,0,2,0,30,10,20
2016,Los Angeles County,44799,36253,23734,12519,313,187,126,44799,36253,23734,12519,313,187,126,16721,9316,7405,19219,14231,4988, , , ,2040,966,261,476,337,1040,688,73,157,122,5466,4036,1430
2016,Madera County,359,209,155,54, , , ,359,209,155,54, , , ,107,79,28,102,76,26, , , ,37,18,9,9,1,0,0,0,0,0,113,85,28
2016,Marin County,837,607,435,172,6,4,2,837,607,435,172,6,4,2,291,191,100,310,240,70, , , ,81,30,9,23,19,36,22,4,9,1,113,82,31
2016,Mariposa County,98,71,56,15, , , ,98,71,56,15, , , ,71,56,15, , , , , , ,10,4,1,4,1,0,0,0,0,0,17,13,4
2016,Mendocino County,394,251,181,70, , , ,394,251,181,70, , , ,165,123,42,86,58,28, , , ,51,18,6,18,9,23,13,3,7,0,69,53,16
2016,Merced County,748,510,287,223,21,12,9,748,510,287,223,21,12,9,223,88,135,266,187,79, , , ,65,24,9,22,10,17,14,0,3,0,156,124,32
2016,Modoc County,45,35,26,9, , , ,45,35,26,9, , , ,28,19,9,7,7,0, , , ,5,2,0,0,3,0,0,0,0,0,5,4,1
2016,Mono County,68,51,31,20, , , ,68,51,31,20, , , ,38,21,17,13,10,3, , , ,7,3,2,2,0,0,0,0,0,0,10,9,1
2016,Monterey County,1392,917,658,259,32,20,12,1392,917,658,259,32,20,12,416,295,121,469,343,126, , , ,138,57,35,38,8,56,36,7,10,3,281,203,78
2016,Napa County,599,406,308,98,125,117,8,599,406,308,98,125,117,8,139,100,39,142,91,51, , , ,56,22,12,14,8,23,14,3,5,1,114,90,24
2016,Nevada County,322,225,116,109, , , ,322,225,116,109, , , ,155,63,92,70,53,17, , , ,25,10,3,8,4,13,8,0,4,1,59,44,15
2016,Orange County,9759,7439,4307,3132,99,67,32,9759,7439,4307,3132,99,67,32,3622,1745,1877,3718,2495,1223, , , ,760,273,175,120,192,385,202,74,57,52,1175,815,360
2016,Placer County,1087,829,464,365, , , ,1087,829,464,365, , , ,513,244,269,316,220,96, , , ,109,42,20,37,10,0,0,0,0,0,149,123,26
2016,Plumas County,87,65,33,32, , , ,87,65,33,32, , , ,65,33,32, , , , , , ,8,3,1,3,1,0,0,0,0,0,14,7,7
2016,Riverside County,7353,5415,3021,2394,68,49,19,7353,5415,3021,2394,68,49,19,3939,2003,1936,1408,969,439, , , ,698,246,114,219,119,232,130,34,51,17,1008,756,252
2016,Sacramento County,15907,14656,10038,4618,699,623,76,4684,3433,2266,1167,67,48,19,1923,1247,676,1443,971,472,10591,7197,3394,413,172,41,69,131,148,105,24,16,3,690,368,322
2016,San Benito County,131,87,53,34, , , ,131,87,53,34, , , ,54,26,28,33,27,6, , , ,11,5,2,4,0,0,0,0,0,0,33,24,9
2016,San Bernardino County,6893,5009,3128,1881,267,129,138,6893,5009,3128,1881,267,129,138,3059,1855,1204,1683,1144,539, , , ,440,178,64,128,70,230,133,32,45,20,1214,893,321
2016,San Diego County,10961,8491,5600,2891,312,211,101,10961,8491,5600,2891,312,211,101,4254,2569,1685,3925,2820,1105, , , ,970,323,172,241,234,367,234,49,60,24,1133,905,228
2016,San Francisco County,4996,4105,3203,902,186,77,109,4996,4105,3203,902,186,77,109,1027,830,197,2892,2296,596, , , ,275,137,35,6,97,169,92,16,12,49,447,161,286
2016,San Joaquin County,2289,1701,962,739,41,33,8,2289,1701,962,739,41,33,8,699,274,425,961,655,306, , , ,230,86,54,52,38,79,48,13,15,3,279,207,72
2016,San Luis Obispo County,1083,843,640,203,181,151,30,1083,843,640,203,181,151,30,396,295,101,266,194,72, , , ,93,34,15,27,17,0,0,0,0,0,147,108,39
2016,San Mateo County,2134,1658,1063,595, , , ,2134,1658,1063,595, , , ,681,330,351,977,733,244, , , ,106,53,14,34,5,0,0,0,0,0,370,276,94
2016,Santa Barbara County,1688,1133,803,330,64,44,20,1688,1133,803,330,64,44,20,617,452,165,452,307,145, , , ,128,50,16,39,23,60,32,7,16,5,367,262,105
2016,Santa Clara County,5966,4295,3058,1237,111,52,59,5966,4295,3058,1237,111,52,59,1655,1257,398,2529,1749,780, , , ,517,185,76,132,124,257,126,33,50,48,897,362,535
2016,Santa Cruz County,835,617,360,257,29,17,12,835,617,360,257,29,17,12,332,142,190,256,201,55, , , ,94,38,14,25,17,0,0,0,0,0,124,98,26
2016,Shasta County,552,392,287,105,22,19,3,552,392,287,105,22,19,3,216,153,63,154,115,39, , , ,52,23,11,16,2,0,0,0,0,0,108,80,28
2016,Sierra County,23,17,11,6, , , ,23,17,11,6, , , ,17,11,6, , , , , , ,2,1,0,1,0,0,0,0,0,0,4,3,1
2016,Siskiyou County,229,160,124,36, , , ,229,160,124,36, , , ,108,86,22,52,38,14, , , ,22,8,2,7,5,8,5,0,3,0,39,29,10
2016,Solano County,1508,1115,532,583, , , ,1508,1115,532,583, , , ,526,124,402,589,408,181, , , ,120,51,19,32,18,57,36,7,12,2,216,174,42
2016,Sonoma County,1342,878,604,274,47,27,20,1342,878,604,274,47,27,20,331,232,99,500,345,155, , , ,125,52,14,38,21,51,28,8,11,4,288,229,59
2016,Stanislaus County,1567,1156,839,317,19,11,8,1567,1156,839,317,19,11,8,611,456,155,526,372,154, , , ,121,46,16,32,27,40,28,1,10,1,250,102,148
2016,Sutter County,277,211,157,54, , , ,277,211,157,54, , , ,133,105,28,78,52,26, , , ,23,10,5,4,4,0,0,0,0,0,43,37,6
2016,Tehama County,259,170,115,55, , , ,259,170,115,55, , , ,113,79,34,57,36,21, , , ,26,9,8,8,1,0,0,0,0,0,63,50,13
2016,Trinity County,68,44,35,9, , , ,68,44,35,9, , , ,44,35,9, , , , , , ,8,4,1,1,2,0,0,0,0,0,16,12,4
2016,Tulare County,1932,1258,892,366,6,5,1,1932,1258,892,366,6,5,1,747,531,216,505,356,149, , , ,188,65,56,37,30,87,45,11,14,17,399,288,111
2016,Tuolumne County,197,143,72,71, , , ,197,143,72,71, , , ,126,62,64,17,10,7, , , ,18,7,1,6,4,6,4,1,1,0,30,20,10
2016,Ventura County,2787,2037,1312,725,46,31,15,2787,2037,1312,725,46,31,15,1247,756,491,744,525,219, , , ,257,101,55,47,54,103,59,15,15,14,390,303,87
2016,Yolo County,843,604,336,268,73,46,27,843,604,336,268,73,46,27,263,89,174,268,201,67, , , ,104,39,14,21,30,36,23,5,6,2,99,76,23
2016,Yuba County,305,196,144,52, , , ,305,196,144,52, , , ,162,118,44,34,26,8, , , ,14,9,1,4,0,0,0,0,0,0,95,62,33
2017,Alameda County,5593,4458,2955,1503,245,131,114,5593,4458,2955,1503,245,131,114,1567,998,569,2646,1826,820, , , ,415,153,68,92,102,186,104,18,34,30,534,393,141
2017,Alpine County,19,17,12,5, , , ,19,17,12,5, , , ,17,12,5, , , , , , ,1,0,0,1,0,0,0,0,0,0,1,0,1
2017,Amador County,147,105,66,39, , , ,147,105,66,39, , , ,85,47,38,20,19,1, , , ,22,7,8,5,2,0,0,0,0,0,20,15,5
2017,Butte County,776,511,254,257,24,15,9,776,511,254,257,24,15,9,263,98,165,224,141,83, , , ,98,31,26,23,18,0,0,0,0,0,167,78,89
2017,Calaveras County,139,113,58,55, , , ,139,113,58,55, , , ,106,52,54,7,6,1, , , ,9,5,2,0,2,0,0,0,0,0,17,11,6
2017,Colusa County,112,82,59,23, , , ,112,82,59,23, , , ,59,39,20,23,20,3, , , ,12,4,3,3,2,0,0,0,0,0,18,11,7
2017,Contra Costa County,3175,2553,1782,771,314,208,106,2893,2271,1595,676,32,21,11,956,628,328,1283,946,337, , , ,211,101,33,44,33,133,82,12,19,20,278,224,54
2017,Del Norte County,111,64,33,31, , , ,111,64,33,31, , , ,53,23,30,11,10,1, , , ,9,4,2,3,0,0,0,0,0,0,38,26,12
2017,El Dorado County,633,436,215,221, , , ,633,436,215,221, , , ,354,161,193,82,54,28, , , ,56,21,15,10,10,23,14,3,6,0,118,95,23
2017,Fresno County,3804,2908,1779,1129,289,255,34,3804,2908,1779,1129,289,255,34,1111,412,699,1508,1112,396, , , ,238,109,50,59,20,113,69,15,21,8,545,419,126
2017,Glenn County,100,75,37,38, , , ,100,75,37,38, , , ,62,27,35,13,10,3, , , ,8,4,0,4,0,0,0,0,0,0,17,14,3
2017,Humboldt County,579,403,290,113,20,12,8,579,403,290,113,20,12,8,242,181,61,141,97,44, , , ,54,18,9,18,9,25,14,3,8,0,97,72,25
2017,Imperial County,652,453,312,141, , , ,652,453,312,141, , , ,281,189,92,172,123,49, , , ,75,22,19,16,18,25,15,3,7,0,99,78,21
2017,Inyo County,112,80,48,32, , , ,112,80,48,32, , , ,63,36,27,17,12,5, , , ,10,4,2,3,1,0,0,0,0,0,22,16,6
2017,Kern County,2819,1972,1382,590,22,13,9,2819,1972,1382,590,22,13,9,1151,812,339,799,557,242, , , ,214,94,47,53,20,82,57,11,12,2,551,437,114
2017,Kings County,624,448,193,255, , , ,624,448,193,255, , , ,278,73,205,170,120,50, , , ,63,21,14,18,10,0,0,0,0,0,113,90,23
2017,Lake County,233,167,76,91, , , ,233,167,76,91, , , ,131,47,84,36,29,7, , , ,27,14,4,8,1,0,0,0,0,0,39,27,12
2017,Lassen County,152,102,78,24, , , ,152,102,78,24, , , ,85,64,21,17,14,3, , , ,12,6,1,3,2,5,3,0,2,0,33,28,5
2017,Los Angeles County,44115,35442,24003,11439,325,192,133,44115,35442,24003,11439,325,192,133,15721,9413,6308,19396,14398,4998, , , ,2120,997,261,489,373,1040,688,73,157,122,5513,4040,1473
2017,Madera County,368,216,156,60, , , ,368,216,156,60, , , ,114,83,31,102,73,29, , , ,37,17,10,8,2,0,0,0,0,0,115,86,29
2017,Marin County,835,611,432,179,8,6,2,835,611,432,179,8,6,2,291,189,102,312,237,75, , , ,79,31,10,22,16,37,23,4,9,1,108,77,31
2017,Mariposa County,103,75,60,15, , , ,103,75,60,15, , , ,75,60,15, , , , , , ,12,4,1,3,4,0,0,0,0,0,16,12,4
2017,Mendocino County,416,275,185,90, , , ,416,275,185,90, , , ,189,128,61,86,57,29, , , ,52,19,6,17,10,21,12,3,6,0,68,55,13
2017,Merced County,777,534,307,227,25,14,11,777,534,307,227,25,14,11,242,106,136,267,187,80, , , ,79,26,19,21,13,19,15,0,4,0,145,119,26
2017,Modoc County,45,36,27,9, , , ,45,36,27,9, , , ,29,20,9,7,7,0, , , ,4,2,0,2,0,0,0,0,0,0,5,4,1
2017,Mono County,71,53,32,21, , , ,71,53,32,21, , , ,40,22,18,13,10,3, , , ,8,4,2,2,0,0,0,0,0,0,10,7,3
2017,Monterey County,1457,979,682,297,31,19,12,1457,979,682,297,31,19,12,446,296,150,502,367,135, , , ,151,59,36,45,11,56,36,7,10,3,271,195,76
2017,Napa County,613,412,311,101,126,115,11,613,412,311,101,126,115,11,133,101,32,153,95,58, , , ,58,22,12,14,10,23,14,3,5,1,120,92,28
2017,Nevada County,329,232,120,112, , , ,329,232,120,112, , , ,156,62,94,76,58,18, , , ,27,10,4,10,3,11,7,0,4,0,59,44,15
2017,Orange County,9930,7649,4440,3209,113,77,36,9930,7649,4440,3209,113,77,36,3755,1843,1912,3781,2520,1261, , , ,760,320,177,105,158,387,206,88,55,38,1134,772,362
2017,Placer County,1119,860,465,395, , , ,1119,860,465,395, , , ,538,250,288,322,215,107, , , ,114,43,21,34,16,0,0,0,0,0,145,119,26
2017,Plumas County,87,66,34,32, , , ,87,66,34,32, , , ,66,34,32, , , , , , ,7,3,1,2,1,0,0,0,0,0,14,7,7
2017,Riverside County,7030,5127,2868,2259,73,54,19,7030,5127,2868,2259,73,54,19,3643,1831,1812,1411,983,428, , , ,698,246,114,219,119,232,132,32,47,21,973,729,244
2017,Sacramento County,16041,14853,10301,4552,727,650,77,4648,3460,2298,1162,71,48,23,1955,1279,676,1434,971,463,10737,7401,3336,422,173,44,73,132,143,100,23,17,3,623,519,104
2017,San Benito County,139,93,56,37, , , ,139,93,56,37, , , ,56,25,31,37,31,6, , , ,11,5,2,4,0,0,0,0,0,0,35,23,12
2017,San Bernardino County,7522,5551,3276,2275,309,150,159,7522,5551,3276,2275,309,150,159,3509,1957,1552,1733,1169,564, , , ,440,178,64,128,70,232,129,37,57,9,1299,926,373
2017,San Diego County,10851,8300,5573,2727,313,208,105,10851,8300,5573,2727,313,208,105,4290,2601,1689,3697,2764,933, , , ,928,331,235,123,239,381,235,51,59,36,1242,971,271
2017,San Francisco County,5101,4181,3271,910,192,77,115,5101,4181,3271,910,192,77,115,1054,862,192,2935,2332,603, , , ,293,141,36,5,111,184,93,20,43,28,443,154,289
2017,San Joaquin County,2329,1766,1015,751,43,31,12,2329,1766,1015,751,43,31,12,724,299,425,999,685,314, , , ,204,79,44,61,20,79,49,13,13,4,280,207,73
2017,San Luis Obispo County,1109,859,648,211,213,178,35,1109,859,648,211,213,178,35,375,270,105,271,200,71, , , ,98,34,13,23,28,0,0,0,0,0,152,116,36
2017,San Mateo County,2219,1679,1060,619, , , ,2219,1679,1060,619, , , ,710,341,369,969,719,250, , , ,125,54,13,33,25,0,0,0,0,0,415,308,107
2017,Santa Barbara County,1669,1147,809,338,67,43,24,1669,1147,809,338,67,43,24,626,458,168,454,308,146, , , ,128,50,16,40,22,70,37,7,19,7,324,227,97
2017,Santa Clara County,6128,4352,3082,1270,121,56,65,6128,4352,3082,1270,121,56,65,1684,1264,420,2547,1762,785, , , ,587,190,86,134,177,260,127,35,48,50,929,364,565
2017,Santa Cruz County,846,621,364,257,31,20,11,846,621,364,257,31,20,11,326,141,185,264,203,61, , , ,99,38,14,25,22,0,0,0,0,0,126,100,26
2017,Shasta County,551,370,272,98,26,20,6,551,370,272,98,26,20,6,184,129,55,160,123,37, , , ,67,24,11,26,6,0,0,0,0,0,114,85,29
2017,Sierra County,19,13,8,5, , , ,19,13,8,5, , , ,13,8,5, , , , , , ,2,1,0,1,0,0,0,0,0,0,4,3,1
2017,Siskiyou County,222,153,115,38, , , ,222,153,115,38, , , ,98,75,23,55,40,15, , , ,22,8,3,6,5,8,5,0,3,0,39,30,9
2017,Solano County,1568,1127,532,595, , , ,1568,1127,532,595, , , ,534,124,410,593,408,185, , , ,133,54,12,35,32,93,57,10,22,4,215,174,41
2017,Sonoma County,1625,1156,598,558,42,25,17,1625,1156,598,558,42,25,17,614,229,385,500,344,156, , , ,128,51,14,48,15,51,31,8,11,1,290,227,63
2017,Stanislaus County,1664,1207,867,340,20,12,8,1664,1207,867,340,20,12,8,652,484,168,535,371,164, , , ,127,45,16,31,35,43,28,4,10,1,287,227,60
2017,Sutter County,281,216,161,55, , , ,281,216,161,55, , , ,131,106,25,85,55,30, , , ,23,10,5,4,4,0,0,0,0,0,42,36,6
2017,Tehama County,260,178,120,58, , , ,260,178,120,58, , , ,118,84,34,60,36,24, , , ,23,7,7,8,1,0,0,0,0,0,59,47,12
2017,Trinity County,74,47,35,12, , , ,74,47,35,12, , , ,47,35,12, , , , , , ,11,4,1,3,3,0,0,0,0,0,16,13,3
2017,Tulare County,1949,1263,910,353,7,6,1,1949,1263,910,353,7,6,1,747,547,200,509,357,152, , , ,188,65,56,37,30,88,46,11,14,17,410,301,109
2017,Tuolumne County,223,149,73,76, , , ,223,149,73,76, , , ,133,64,69,16,9,7, , , ,22,7,2,7,6,7,4,1,2,0,45,32,13
2017,Ventura County,2819,2061,1339,722,43,28,15,2819,2061,1339,722,43,28,15,1247,767,480,771,544,227, , , ,263,97,54,50,62,107,59,17,15,16,388,296,92
2017,Yolo County,844,602,336,266,70,45,25,844,602,336,266,70,45,25,257,87,170,275,204,71, , , ,100,37,14,30,19,36,23,5,6,2,106,79,27
2017,Yuba County,303,190,143,47, , , ,303,190,143,47, , , ,156,117,39,34,26,8, , , ,15,9,2,4,0,0,0,0,0,0,98,63,35
2018,Alameda County,5481,4356,2847,1509,225,126,99,5481,4356,2847,1509,225,126,99,1537,939,598,2594,1782,812, , , ,415,153,68,92,102,178,107,20,33,18,532,387,145
2018,Alpine County,18,15,12,3, , , ,18,15,12,3, , , ,15,12,3, , , , , , ,1,0,0,1,0,0,0,0,0,0,2,1,1
2018,Amador County,151,111,66,45, , , ,151,111,66,45, , , ,90,46,44,21,20,1, , , ,23,8,8,5,2,0,0,0,0,0,17,13,4
2018,Butte County,776,516,256,260,25,15,10,776,516,256,260,25,15,10,263,98,165,228,143,85, , , ,93,30,23,28,12,0,0,0,0,0,167,78,89
2018,Calaveras County,138,104,52,52, , , ,138,104,52,52, , , ,99,48,51,5,4,1, , , ,15,7,1,5,2,0,0,0,0,0,19,12,7
2018,Colusa County,109,80,59,21, , , ,109,80,59,21, , , ,58,40,18,22,19,3, , , ,12,4,3,3,2,0,0,0,0,0,17,9,8
2018,Contra Costa County,3334,2620,1846,774,369,250,119,2997,2283,1617,666,32,21,11,961,647,314,1290,949,341, , , ,210,98,31,49,32,138,86,13,14,25,366,306,60
2018,Del Norte County,103,65,34,31, , , ,103,65,34,31, , , ,53,23,30,12,11,1, , , ,9,4,1,4,0,0,0,0,0,0,29,21,8
2018,El Dorado County,622,422,201,221, , , ,622,422,201,221, , , ,341,150,191,81,51,30, , , ,56,23,15,5,13,22,14,4,4,0,122,94,28
2018,Fresno County,3956,2995,1854,1141,319,284,35,3956,2995,1854,1141,319,284,35,1152,430,722,1524,1140,384, , , ,253,112,57,68,16,123,72,17,22,12,585,440,145
2018,Glenn County,102,80,43,37, , , ,102,80,43,37, , , ,68,33,35,12,10,2, , , ,7,3,0,4,0,0,0,0,0,0,15,12,3
2018,Humboldt County,572,398,296,102,20,12,8,572,398,296,102,20,12,8,240,186,54,138,98,40, , , ,54,18,8,18,10,30,15,5,9,1,90,70,20
2018,Imperial County,660,454,311,143, , , ,660,454,311,143, , , ,275,187,88,179,124,55, , , ,78,19,17,15,27,27,17,3,7,0,101,84,17
2018,Inyo County,129,97,48,49, , , ,129,97,48,49, , , ,77,36,41,20,12,8, , , ,11,4,2,3,2,0,0,0,0,0,21,16,5
2018,Kern County,2838,2021,1431,590,52,41,11,2838,2021,1431,590,52,41,11,1163,806,357,806,584,222, , , ,211,93,44,65,9,82,53,11,17,1,524,421,103
2018,Kings County,627,454,205,249, , , ,627,454,205,249, , , ,286,83,203,168,122,46, , , ,63,21,16,18,8,0,0,0,0,0,110,89,21
2018,Lake County,174,111,79,32, , , ,174,111,79,32, , , ,68,49,19,43,30,13, , , ,26,14,5,6,1,0,0,0,0,0,37,28,9
2018,Lassen County,150,99,70,29, , , ,150,99,70,29, , , ,84,57,27,15,13,2, , , ,14,6,1,3,4,6,4,0,2,0,31,23,8
2018,Los Angeles County,44335,35751,24090,11661,448,298,150,44335,35751,24090,11661,448,298,150,15754,9426,6328,19549,14366,5183, , , ,2097,982,253,490,372,1020,678,76,148,118,5467,3781,1686
2018,Madera County,394,237,167,70, , , ,394,237,167,70, , , ,116,85,31,121,82,39, , , ,41,19,10,9,3,0,0,0,0,0,116,86,30
2018,Marin County,835,615,443,172,8,6,2,835,615,443,172,8,6,2,291,196,95,316,241,75, , , ,78,29,12,29,8,37,24,4,7,2,105,74,31
2018,Mariposa County,103,74,60,14, , , ,103,74,60,14, , , ,74,60,14, , , , , , ,12,4,1,4,3,0,0,0,0,0,17,13,4
2018,Mendocino County,413,276,184,92, , , ,413,276,184,92, , , ,197,135,62,79,49,30, , , ,52,19,6,17,10,21,12,2,7,0,64,49,15
2018,Merced County,796,552,320,232,26,15,11,796,552,320,232,26,15,11,249,117,132,277,188,89, , , ,85,29,21,22,13,22,17,0,3,2,137,111,26
2018,Modoc County,47,37,27,10, , , ,47,37,27,10, , , ,28,19,9,9,8,1, , , ,5,2,0,2,1,0,0,0,0,0,5,4,1
2018,Mono County,76,57,34,23, , , ,76,57,34,23, , , ,41,21,20,16,13,3, , , ,9,4,2,3,0,0,0,0,0,0,10,9,1
2018,Monterey County,1427,947,696,251,25,15,10,1427,947,696,251,25,15,10,426,304,122,496,377,119, , , ,151,59,36,45,11,63,40,7,11,5,266,193,73
2018,Napa County,611,412,308,104,129,118,11,611,412,308,104,129,118,11,135,99,36,148,91,57, , , ,59,22,13,14,10,23,14,3,5,1,117,95,22
2018,Nevada County,317,228,122,106, , , ,317,228,122,106, , , ,151,62,89,77,60,17, , , ,27,10,4,10,3,12,8,0,3,1,50,37,13
2018,Orange County,9957,7621,4475,3146,111,76,35,9957,7621,4475,3146,111,76,35,3735,1880,1855,3775,2519,1256, , , ,808,283,179,117,229,399,212,89,54,44,1129,747,382
2018,Placer County,1129,864,478,386, , , ,1129,864,478,386, , , ,543,260,283,321,218,103, , , ,118,44,21,47,6,0,0,0,0,0,147,119,28
2018,Plumas County,84,62,33,29, , , ,84,62,33,29, , , ,62,33,29, , , , , , ,9,3,2,3,1,0,0,0,0,0,13,6,7
2018,Riverside County,6837,5042,2846,2196,68,54,14,6837,5042,2846,2196,68,54,14,3530,1795,1735,1444,997,447, , , ,670,243,157,150,120,220,126,29,44,21,905,666,239
2018,Sacramento County,15789,14571,10182,4389,689,617,72,4643,3425,2324,1101,72,45,27,1898,1302,596,1455,977,478,10529,7286,3243,424,173,44,76,131,148,102,23,20,3,646,544,102
2018,San Benito County,138,94,56,38, , , ,138,94,56,38, , , ,54,24,30,40,32,8, , , ,11,5,2,4,0,0,0,0,0,0,33,26,7
2018,San Bernardino County,7474,5519,3382,2137,359,188,171,7474,5519,3382,2137,359,188,171,3407,2018,1389,1753,1176,577, , , ,510,215,57,129,109,230,126,38,52,14,1215,415,800
2018,San Diego County,10776,8366,5524,2842,320,209,111,10776,8366,5524,2842,320,209,111,4283,2572,1711,3763,2743,1020, , , ,922,319,133,223,247,380,233,53,65,29,1108,762,346
2018,San Francisco County,5013,4157,3238,919,199,72,127,5013,4157,3238,919,199,72,127,1045,860,185,2913,2306,607, , , ,299,139,40,4,116,194,102,21,43,28,363,156,207
2018,San Joaquin County,2422,1828,1061,767,43,34,9,2422,1828,1061,767,43,34,9,740,302,438,1045,725,320, , , ,232,85,39,20,88,84,49,17,13,5,278,214,64
2018,San Luis Obispo County,1163,913,692,221,239,199,40,1163,913,692,221,239,199,40,409,305,104,265,188,77, , , ,94,34,15,27,18,0,0,0,0,0,156,119,37
2018,San Mateo County,2188,1707,1060,647, , , ,2188,1707,1060,647, , , ,734,348,386,973,712,261, , , ,130,57,13,39,21,0,0,0,0,0,351,255,96
2018,Santa Barbara County,1634,1140,812,328,73,47,26,1634,1140,812,328,73,47,26,624,454,170,443,311,132, , , ,127,51,13,42,21,73,39,10,16,8,294,206,88
2018,Santa Clara County,6364,4571,3270,1301,121,55,66,6364,4571,3270,1301,121,55,66,1694,1279,415,2756,1936,820, , , ,598,191,88,137,182,266,128,31,54,53,929,335,594
2018,Santa Cruz County,861,634,360,274,36,19,17,861,634,360,274,36,19,17,328,140,188,270,201,69, , , ,101,38,14,26,23,0,0,0,0,0,126,100,26
2018,Shasta County,555,387,282,105,25,19,6,555,387,282,105,25,19,6,198,138,60,164,125,39, , , ,61,24,10,14,13,0,0,0,0,0,107,82,25
2018,Sierra County,19,13,9,4, , , ,19,13,9,4, , , ,13,9,4, , , , , , ,2,1,0,1,0,0,0,0,0,0,4,3,1
2018,Siskiyou County,222,154,85,69, , , ,222,154,85,69, , , ,99,44,55,55,41,14, , , ,21,7,3,7,4,8,5,0,3,0,39,19,20
2018,Solano County,1536,1117,542,575, , , ,1536,1117,542,575, , , ,507,123,384,610,419,191, , , ,136,57,12,35,32,85,52,9,18,6,198,154,44
2018,Sonoma County,1612,1144,601,543,37,23,14,1612,1144,601,543,37,23,14,608,232,376,499,346,153, , , ,123,48,12,48,15,51,31,8,11,1,294,231,63
2018,Stanislaus County,1676,1220,884,336,19,11,8,1676,1220,884,336,19,11,8,681,508,173,520,365,155, , , ,126,44,16,31,35,44,28,4,10,2,286,222,64
2018,Sutter County,291,220,165,55, , , ,291,220,165,55, , , ,132,107,25,88,58,30, , , ,28,12,6,4,6,0,0,0,0,0,43,36,7
2018,Tehama County,265,175,117,58, , , ,265,175,117,58, , , ,114,79,35,61,38,23, , , ,24,8,7,8,1,0,0,0,0,0,66,58,8
2018,Trinity County,69,42,30,12, , , ,69,42,30,12, , , ,42,30,12, , , , , , ,10,3,1,4,2,0,0,0,0,0,17,14,3
2018,Tulare County,1977,1282,900,382,7,6,1,1977,1282,900,382,7,6,1,761,536,225,514,358,156, , , ,195,62,46,43,44,89,46,11,14,18,411,304,107
2018,Tuolumne County,223,148,72,76, , , ,223,148,72,76, , , ,131,62,69,17,10,7, , , ,23,8,2,6,7,7,4,1,2,0,45,32,13
2018,Ventura County,2825,2041,1321,720,44,28,16,2825,2041,1321,720,44,28,16,1232,760,472,765,533,232, , , ,279,102,62,47,68,101,56,15,15,15,404,313,91
2018,Yolo County,856,600,331,269,65,43,22,856,600,331,269,65,43,22,259,84,175,276,204,72, , , ,104,39,22,23,20,39,23,5,6,5,113,84,29
2018,Yuba County,300,189,144,45, , , ,300,189,144,45, , , ,155,118,37,34,26,8, , , ,14,9,2,3,0,0,0,0,0,0,97,64,33
2019,Alameda County,5433,4321,2865,1456,209,120,89,5433,4321,2865,1456,209,120,89,1496,950,546,2616,1795,821, , , ,403,153,67,78,105,181,107,19,31,24,528,188,340
2019,Alpine County,21,16,13,3, , , ,21,16,13,3, , , ,16,13,3, , , , , , ,3,1,0,2,0, , , , , ,2,1,1
2019,Amador County,162,117,71,46, , , ,162,117,71,46, , , ,94,49,45,23,22,1, , , ,26,9,9,6,2, , , , , ,19,15,4
2019,Butte County,739,502,258,244,28,18,10,739,502,258,244,28,18,10,252,101,151,222,139,83, , , ,85,27,23,20,15, , , , , ,152,117,35
2019,Calaveras County,159,121,65,56, , , ,159,121,65,56, , , ,113,58,55,8,7,1, , , ,18,8,3,5,2, , , , , ,20,13,7
2019,Colusa County,113,79,57,22, , , ,113,79,57,22, , , ,59,40,19,20,17,3, , , ,13,4,3,3,3, , , , , ,21,12,9
2019,Contra Costa County,3301,2591,1802,789,359,237,122,2975,2265,1586,679,33,21,12,928,612,316,1304,953,351, , , ,206,98,24,47,37,137,82,12,22,21,367,307,60
2019,Del Norte County,113,64,32,32, , , ,113,64,32,32, , , ,52,21,31,12,11,1, , , ,14,7,2,4,1, , , , , ,35,26,9
2019,El Dorado County,618,428,210,218, , , ,618,428,210,218, , , ,344,154,190,84,56,28, , , ,54,21,18,11,4,22,14,4,3,1,114,86,28
2019,Fresno County,4019,3049,1841,1208,339,292,47,4019,3049,1841,1208,339,292,47,1182,414,768,1528,1135,393, , , ,237,112,57,51,17,138,82,18,23,15,595,444,151
2019,Glenn County,111,86,44,42, , , ,111,86,44,42, , , ,73,33,40,13,11,2, , , ,8,3,1,4,0, , , , , ,17,13,4
2019,Humboldt County,593,413,302,111,20,12,8,593,413,302,111,20,12,8,245,187,58,148,103,45, , , ,58,18,10,18,12,30,15,5,9,1,92,71,21
2019,Imperial County,634,446,306,140, , , ,634,446,306,140, , , ,272,187,85,174,119,55, , , ,63,17,23,15,8,25,17,2,6,0,100,85,15
2019,Inyo County,130,97,50,47, , , ,130,97,50,47, , , ,78,38,40,19,12,7, , , ,12,4,2,3,3, , , , , ,21,17,4
2019,Kern County,2879,2048,1388,660,57,43,14,2879,2048,1388,660,57,43,14,1155,779,376,836,566,270, , , ,230,102,48,71,9,77,49,10,17,1,524,421,103
2019,Kings County,644,467,212,255, , , ,644,467,212,255, , , ,289,85,204,178,127,51, , , ,63,21,16,18,8, , , , , ,114,92,22
2019,Lake County,233,171,125,46, , , ,233,171,125,46, , , ,122,91,31,49,34,15, , , ,23,10,5,7,1, , , , , ,39,30,9
2019,Lassen County,140,99,74,25, , , ,140,99,74,25, , , ,80,58,22,19,16,3, , , ,13,4,1,3,5,5,3,0,2,0,23,15,8
2019,Los Angeles County,44181,35898,24269,11629,459,311,148,44181,35898,24269,11629,459,311,148,15930,9565,6365,19509,14393,5116, , , ,2080,964,249,496,371,1005,713,77,142,73,5198,3780,1418
2019,Madera County,392,240,170,70, , , ,392,240,170,70, , , ,121,86,35,119,84,35, , , ,40,18,9,9,4, , , , , ,112,90,22
2019,Marin County,829,608,436,172,7,5,2,829,608,436,172,7,5,2,298,194,104,303,237,66, , , ,77,30,7,21,19,36,24,4,7,1,108,78,30
2019,Mariposa County,105,78,62,16, , , ,105,78,62,16, , , ,78,62,16, , , , , , ,13,4,1,4,4, , , , , ,14,10,4
2019,Mendocino County,413,282,180,102, , , ,413,282,180,102, , , ,202,131,71,80,49,31, , , ,52,19,6,17,10,26,14,3,7,2,53,43,10
2019,Merced County,801,562,327,235,28,16,12,801,562,327,235,28,16,12,255,122,133,279,189,90, , , ,84,29,20,22,13,20,15,0,3,2,135,109,26
2019,Modoc County,48,38,27,11, , , ,48,38,27,11, , , ,30,20,10,8,7,1, , , ,5,2,0,2,1, , , , , ,5,4,1
2019,Mono County,78,56,32,24, , , ,78,56,32,24, , , ,41,20,21,15,12,3, , , ,10,4,2,4,0, , , , , ,12,10,2
2019,Monterey County,1433,948,686,262,23,14,9,1433,948,686,262,23,14,9,430,295,135,495,377,118, , , ,158,60,38,49,11,56,29,7,12,8,271,198,73
2019,Napa County,622,416,312,104,133,121,12,622,416,312,104,133,121,12,134,100,34,149,91,58, , , ,66,24,15,16,11,23,14,3,5,1,117,95,22
2019,Nevada County,326,238,122,116, , , ,326,238,122,116, , , ,152,59,93,86,63,23, , , ,26,10,4,9,3,12,9,0,3,0,50,38,12
2019,Orange County,10012,7710,4522,3188,155,80,75,10012,7710,4522,3188,155,80,75,3723,1888,1835,3832,2554,1278, , , ,801,210,182,183,226,413,190,76,59,88,1088,736,352
2019,Placer County,1132,866,477,389, , , ,1132,866,477,389, , , ,534,248,286,332,229,103, , , ,119,44,19,37,19, , , , , ,147,119,28
2019,Plumas County,89,66,36,30, , , ,89,66,36,30, , , ,66,36,30, , , , , , ,7,3,1,2,1, , , , , ,16,8,8
2019,Riverside County,6995,5296,2868,2428,67,53,14,6995,5296,2868,2428,67,53,14,3750,1788,1962,1479,1027,452, , , ,662,237,102,147,176,215,123,28,45,19,822,606,216
2019,Sacramento County,15958,14731,10202,4529,695,615,80,4802,3575,2399,1176,68,42,26,1992,1348,644,1515,1009,506,10529,7230,3299,426,173,79,65,109,150,100,21,20,9,651,547,104
2019,San Benito County,151,99,56,43, , , ,151,99,56,43, , , ,59,23,36,40,33,7, , , ,16,6,3,4,3, , , , , ,36,29,7
2019,San Bernardino County,7463,5455,3327,2128,347,183,164,7463,5455,3327,2128,347,183,164,3342,1927,1415,1766,1217,549, , , ,579,229,57,162,131,237,128,40,48,21,1192,893,299
2019,San Diego County,10968,8510,5605,2905,317,212,105,10968,8510,5605,2905,317,212,105,4344,2601,1743,3849,2792,1057, , , ,932,328,125,239,240,418,247,61,69,41,1108,823,285
2019,San Francisco County,4979,4133,3207,926,182,71,111,4979,4133,3207,926,182,71,111,1044,857,187,2907,2279,628, , , ,295,135,39,2,119,196,102,22,45,27,355,232,123
2019,San Joaquin County,2492,1838,1054,784,49,36,13,2492,1838,1054,784,49,36,13,737,293,444,1052,725,327, , , ,271,97,62,58,54,89,50,17,15,7,294,216,78
2019,San Luis Obispo County,1177,916,697,219,215,190,25,1177,916,697,219,215,190,25,418,303,115,283,204,79, , , ,110,38,17,32,23, , , , , ,151,116,35
2019,San Mateo County,2169,1708,1047,661, , , ,2169,1708,1047,661, , , ,746,334,412,962,713,249, , , ,134,59,16,42,17, , , , , ,327,232,95
2019,Santa Barbara County,1716,1209,840,369,76,48,28,1716,1209,840,369,76,48,28,674,477,197,459,315,144, , , ,130,51,15,42,22,82,37,10,19,16,295,211,84
2019,Santa Clara County,6430,4675,3365,1310,121,55,66,6430,4675,3365,1310,121,55,66,1716,1316,400,2838,1994,844, , , ,621,196,90,136,199,272,135,34,49,54,862,641,221
2019,Santa Cruz County,854,639,362,277,38,21,17,854,639,362,277,38,21,17,334,148,186,267,193,74, , , ,104,39,15,26,24, , , , , ,111,65,46
2019,Shasta County,560,391,278,113,25,19,6,560,391,278,113,25,19,6,198,138,60,168,121,47, , , ,69,25,11,15,18, , , , , ,100,75,25
2019,Sierra County,18,12,6,6, , , ,18,12,6,6, , , ,12,6,6, , , , , , ,2,1,0,1,0, , , , , ,4,3,1
2019,Siskiyou County,218,159,120,39, , , ,218,159,120,39, , , ,103,81,22,56,39,17, , , ,18,7,3,4,4,7,5,0,2,0,34,25,9
2019,Solano County,1551,1131,532,599, , , ,1551,1131,532,599, , , ,512,122,390,619,410,209, , , ,140,58,12,34,36,89,54,9,19,7,191,146,45
2019,Sonoma County,1598,1140,603,537,36,20,16,1598,1140,603,537,36,20,16,581,223,358,523,360,163, , , ,124,50,13,37,24,51,28,7,11,5,283,220,63
2019,Stanislaus County,1694,1262,903,359,20,12,8,1694,1262,903,359,20,12,8,706,527,179,536,364,172, , , ,132,45,18,32,37,50,31,4,13,2,250,191,59
2019,Sutter County,287,216,164,52, , , ,287,216,164,52, , , ,128,105,23,88,59,29, , , ,27,10,5,10,2, , , , , ,44,37,7
2019,Tehama County,256,168,111,57, , , ,256,168,111,57, , , ,107,73,34,61,38,23, , , ,19,4,7,7,1, , , , , ,69,57,12
2019,Trinity County,77,50,36,14, , , ,77,50,36,14, , , ,50,36,14, , , , , , ,12,4,1,3,4, , , , , ,15,14,1
2019,Tulare County,2011,1332,939,393,7,6,1,2011,1332,939,393,7,6,1,791,563,228,534,370,164, , , ,187,61,39,41,46,86,45,11,13,17,406,299,107
2019,Tuolumne County,225,148,70,78, , , ,225,148,70,78, , , ,131,60,71,17,10,7, , , ,24,7,2,8,7,7,4,1,2,0,46,33,13
2019,Ventura County,2832,2016,1324,692,41,28,13,2832,2016,1324,692,41,28,13,1231,761,470,744,535,209, , , ,292,105,52,39,96,109,60,17,15,17,415,311,104
2019,Yolo County,868,610,327,283,67,41,26,868,610,327,283,67,41,26,262,84,178,281,202,79, , , ,95,36,13,23,23,41,23,5,6,7,122,89,33
2019,Yuba County,302,198,152,46, , , ,302,198,152,46, , , ,163,126,37,35,26,9, , , ,12,7,2,2,1, , , , , ,92,60,32
